,Time,Date,Day of the week,CarCount,BikeCount,BusCount,TruckCount,Total,Traffic Situation
0,9:45:00 AM,17,Tuesday,92,19,15,7,133,normal
1,11:15:00 PM,27,Friday,19,4,0,12,35,low
2,7:45:00 PM,14,Saturday,56,7,12,12,87,low
3,6:30:00 AM,16,Monday,118,40,40,3,201,heavy
4,1:15:00 AM,27,Friday,15,5,0,27,47,normal
5,12:15:00 AM,15,Sunday,19,3,0,38,60,normal
6,11:15:00 AM,29,Sunday,43,7,12,23,85,normal
7,1:00:00 PM,10,Tuesday,52,10,13,21,96,normal
8,9:45:00 AM,25,Wednesday,42,2,28,27,99,normal
9,3:45:00 AM,25,Wednesday,16,4,0,35,55,normal
10,10:30:00 AM,6,Monday,42,3,27,18,90,normal
11,8:45:00 AM,24,Tuesday,102,14,46,1,163,high
12,11:45:00 AM,1,Wednesday,37,9,7,25,78,normal
13,2:00:00 AM,19,Thursday,19,0,1,20,40,normal
14,4:45:00 AM,7,Tuesday,82,15,0,19,116,normal
15,5:15:00 AM,15,Sunday,75,1,7,9,92,low
16,12:15:00 PM,15,Sunday,54,10,12,25,101,normal
17,2:00:00 PM,25,Wednesday,22,28,11,18,79,normal
18,7:15:00 PM,31,Tuesday,104,18,18,23,163,high
19,5:30:00 AM,7,Tuesday,66,6,9,5,86,low
20,4:45:00 AM,28,Saturday,108,10,5,17,140,normal
21,12:00:00 AM,3,Friday,13,0,0,32,45,normal
22,11:30:00 AM,30,Monday,34,6,7,25,72,normal
23,1:30:00 AM,18,Wednesday,11,0,1,40,52,normal
24,9:15:00 AM,1,Wednesday,77,13,7,23,120,high
25,7:15:00 AM,25,Wednesday,142,32,27,2,203,heavy
26,5:00:00 AM,3,Friday,33,17,0,13,63,normal
27,6:30:00 AM,3,Friday,35,14,2,14,65,normal
28,3:45:00 AM,16,Monday,16,5,1,31,53,normal
29,12:30:00 AM,20,Friday,16,2,0,15,33,normal
30,1:30:00 AM,10,Tuesday,37,0,1,4,42,low
31,11:30:00 AM,23,Monday,40,9,15,28,92,normal
32,6:00:00 AM,20,Friday,41,16,7,15,79,normal
33,1:00:00 AM,29,Sunday,19,5,0,12,36,low
34,11:30:00 AM,6,Monday,46,8,6,26,86,normal
35,1:45:00 PM,1,Wednesday,108,17,33,7,165,high
36,3:00:00 AM,28,Saturday,10,2,1,34,47,normal
37,10:15:00 AM,8,Wednesday,81,25,40,20,166,high
38,9:45:00 AM,9,Thursday,11,12,21,24,68,normal
39,3:00:00 PM,3,Friday,179,60,12,0,251,heavy
40,2:00:00 PM,30,Monday,83,22,40,20,165,high
41,8:45:00 PM,1,Wednesday,87,11,16,28,142,high
42,9:45:00 PM,2,Thursday,74,5,19,5,103,normal
43,9:00:00 PM,20,Friday,39,6,6,1,52,low
44,1:45:00 PM,15,Sunday,53,12,23,8,96,normal
45,10:00:00 AM,6,Monday,84,18,18,28,148,high
46,4:00:00 PM,20,Friday,81,29,5,0,115,normal
47,9:45:00 PM,5,Sunday,100,17,15,22,154,high
48,5:30:00 AM,30,Monday,101,4,3,12,120,normal
49,4:00:00 PM,12,Thursday,105,35,48,6,194,heavy
50,9:30:00 AM,23,Monday,93,21,22,29,165,high
51,4:15:00 AM,20,Friday,61,5,3,14,83,normal
52,3:30:00 PM,28,Saturday,83,18,6,15,122,normal
53,4:30:00 PM,12,Thursday,103,29,44,6,182,heavy
54,4:00:00 PM,19,Thursday,133,10,46,10,199,heavy
55,10:00:00 PM,6,Monday,16,1,1,24,42,normal
56,8:15:00 PM,6,Monday,56,16,12,9,93,low
57,2:30:00 AM,1,Wednesday,15,0,0,18,33,normal
58,12:00:00 PM,6,Monday,41,8,7,27,83,normal
59,11:30:00 AM,19,Thursday,39,7,10,30,86,normal
60,1:00:00 AM,9,Thursday,18,3,0,14,35,normal
61,1:15:00 AM,18,Wednesday,19,2,0,30,51,normal
62,6:30:00 AM,15,Sunday,139,19,50,2,210,heavy
63,2:45:00 AM,2,Thursday,17,3,1,36,57,normal
64,9:00:00 PM,21,Sunday,65,16,12,32,125,high
65,10:45:00 PM,9,Thursday,16,3,1,36,56,normal
66,9:45:00 PM,23,Monday,106,9,12,31,158,high
67,11:30:00 AM,14,Saturday,58,8,6,23,95,normal
68,7:30:00 PM,25,Wednesday,57,21,20,18,116,normal
69,6:30:00 AM,6,Monday,114,30,36,2,182,heavy
70,9:45:00 PM,15,Sunday,88,8,11,29,136,high
71,9:30:00 AM,17,Tuesday,45,24,5,23,97,normal
72,11:00:00 AM,6,Monday,63,10,8,28,109,normal
73,9:30:00 PM,2,Thursday,68,12,15,32,127,high
74,5:45:00 AM,17,Tuesday,113,7,10,16,146,normal
75,12:00:00 AM,26,Thursday,15,5,1,23,44,normal
76,1:45:00 AM,5,Sunday,18,3,0,28,49,normal
77,11:00:00 PM,13,Friday,19,1,0,31,51,normal
78,3:30:00 AM,5,Sunday,15,3,1,12,31,low
79,6:15:00 PM,25,Wednesday,148,11,42,8,209,heavy
80,4:45:00 PM,9,Thursday,115,20,27,9,171,heavy
81,10:15:00 AM,4,Saturday,34,21,39,16,110,normal
82,3:45:00 PM,10,Tuesday,101,26,8,14,149,normal
83,5:30:00 AM,6,Monday,56,11,9,15,91,normal
84,2:30:00 AM,18,Wednesday,10,0,1,24,35,normal
85,4:00:00 AM,31,Tuesday,13,0,0,16,29,normal
86,8:45:00 AM,27,Friday,52,19,0,10,81,low
87,7:00:00 PM,23,Monday,76,5,14,20,115,normal
88,4:00:00 AM,14,Saturday,15,4,0,16,35,normal
89,8:15:00 AM,9,Thursday,104,19,24,4,151,normal
90,8:15:00 AM,29,Sunday,121,35,37,3,196,heavy
91,7:00:00 PM,21,Sunday,85,14,14,13,126,normal
92,10:30:00 AM,29,Sunday,93,14,10,25,142,high
93,4:30:00 AM,13,Friday,33,11,6,13,63,normal
94,6:00:00 AM,26,Thursday,106,27,45,5,183,heavy
95,2:45:00 PM,2,Thursday,16,18,40,6,80,normal
96,11:45:00 PM,1,Wednesday,14,1,1,17,33,normal
97,6:45:00 AM,28,Saturday,130,31,22,0,183,heavy
98,11:00:00 AM,25,Wednesday,27,7,10,22,66,normal
99,1:30:00 PM,7,Tuesday,101,21,34,18,174,heavy
100,7:00:00 PM,24,Tuesday,64,25,11,15,115,normal
101,2:15:00 AM,12,Thursday,18,1,0,24,43,normal
102,11:30:00 PM,6,Monday,18,3,0,32,53,normal
103,10:00:00 AM,8,Wednesday,42,25,37,12,116,high
104,7:30:00 PM,19,Thursday,94,25,19,8,146,normal
105,1:15:00 AM,26,Thursday,11,4,0,32,47,normal
106,11:30:00 AM,2,Thursday,34,5,4,29,72,normal
107,5:30:00 AM,21,Sunday,51,7,4,5,67,low
108,7:00:00 PM,18,Wednesday,103,14,13,9,139,normal
109,3:15:00 PM,21,Sunday,44,16,9,13,82,normal
110,1:45:00 AM,7,Tuesday,13,5,0,20,38,normal
111,10:15:00 AM,28,Saturday,37,21,28,6,92,normal
112,4:15:00 AM,27,Friday,39,14,0,15,68,normal
113,10:45:00 AM,31,Tuesday,50,22,24,7,103,normal
114,9:45:00 AM,7,Tuesday,31,10,40,9,90,normal
115,11:45:00 PM,15,Sunday,11,0,1,11,23,low
116,1:30:00 AM,9,Thursday,17,1,1,13,32,normal
117,1:30:00 AM,20,Friday,18,4,0,18,40,normal
118,11:45:00 PM,2,Thursday,13,3,0,22,38,normal
119,8:15:00 AM,31,Tuesday,110,34,35,0,179,heavy
120,12:15:00 PM,10,Tuesday,57,8,12,29,106,normal
121,11:30:00 PM,5,Sunday,18,5,1,20,44,normal
122,3:15:00 PM,7,Tuesday,99,26,8,11,144,normal
123,2:00:00 AM,1,Wednesday,17,1,0,29,47,normal
124,8:15:00 PM,23,Monday,54,9,15,7,85,low
125,1:45:00 PM,6,Monday,24,15,26,13,78,normal
126,4:00:00 AM,10,Tuesday,111,28,20,3,162,normal
127,3:30:00 AM,2,Thursday,17,5,1,15,38,normal
128,3:00:00 PM,29,Sunday,53,27,27,17,124,high
129,3:30:00 AM,15,Sunday,20,1,1,39,61,normal
130,4:30:00 AM,7,Tuesday,60,12,8,15,95,normal
131,7:30:00 AM,12,Thursday,114,20,43,1,178,heavy
132,6:30:00 PM,27,Friday,60,29,22,2,113,normal
133,9:30:00 PM,10,Tuesday,75,15,12,21,123,high
134,2:30:00 AM,17,Tuesday,10,2,0,27,39,normal
135,4:30:00 PM,20,Friday,71,24,18,2,115,normal
136,12:00:00 AM,16,Monday,18,4,1,28,51,normal
137,2:15:00 AM,17,Tuesday,12,5,1,19,37,normal
138,7:45:00 PM,2,Thursday,78,13,20,25,136,high
139,4:00:00 PM,7,Tuesday,120,32,39,9,200,heavy
140,7:15:00 AM,29,Sunday,124,14,31,4,173,heavy
141,6:30:00 PM,30,Monday,134,23,49,8,214,heavy
142,3:15:00 AM,30,Monday,14,0,0,15,29,normal
143,3:00:00 PM,14,Saturday,15,11,30,14,70,normal
144,12:45:00 AM,25,Wednesday,19,5,1,22,47,normal
145,11:45:00 AM,22,Saturday,36,9,14,22,81,normal
146,11:30:00 PM,29,Sunday,11,5,1,19,36,normal
147,4:30:00 PM,2,Thursday,110,31,37,7,185,heavy
148,4:45:00 PM,17,Tuesday,126,15,28,6,175,heavy
149,2:15:00 AM,3,Friday,12,3,0,22,37,normal
150,10:30:00 PM,9,Thursday,11,4,0,23,38,normal
151,5:30:00 AM,25,Wednesday,59,25,2,7,93,low
152,1:45:00 PM,4,Saturday,114,11,40,20,185,heavy
153,4:15:00 PM,14,Saturday,150,30,22,5,207,heavy
154,9:00:00 AM,7,Tuesday,126,31,48,2,207,heavy
155,1:30:00 PM,21,Sunday,46,24,35,16,121,high
156,4:15:00 PM,30,Monday,122,21,20,10,173,heavy
157,7:00:00 AM,18,Wednesday,141,15,21,5,182,heavy
158,2:00:00 PM,18,Wednesday,96,22,36,5,159,high
159,3:00:00 AM,22,Saturday,13,1,1,33,48,normal
160,12:00:00 PM,2,Thursday,48,10,13,23,94,normal
161,8:15:00 AM,27,Friday,28,18,5,10,61,low
162,11:30:00 PM,21,Sunday,11,1,1,36,49,normal
163,12:15:00 AM,1,Wednesday,17,5,0,23,45,normal
164,8:00:00 PM,19,Thursday,105,16,15,6,142,normal
165,7:15:00 PM,20,Friday,36,8,3,9,56,low
166,10:45:00 AM,11,Wednesday,55,15,36,15,121,high
167,5:15:00 PM,17,Tuesday,100,21,33,7,161,high
168,2:15:00 AM,2,Thursday,11,0,1,36,48,normal
169,8:30:00 PM,6,Monday,77,6,20,5,108,normal
170,8:45:00 AM,10,Tuesday,107,10,49,2,168,heavy
171,6:45:00 AM,18,Wednesday,113,24,22,2,161,normal
172,7:45:00 AM,9,Thursday,146,22,26,4,198,heavy
173,7:15:00 PM,26,Thursday,81,21,19,7,128,normal
174,4:45:00 PM,8,Wednesday,140,25,46,10,221,heavy
175,12:00:00 AM,6,Monday,11,3,0,26,40,normal
176,10:30:00 PM,23,Monday,12,0,0,22,34,normal
177,4:45:00 PM,19,Thursday,127,25,37,5,194,heavy
178,2:15:00 PM,23,Monday,56,18,29,17,120,high
179,4:45:00 AM,29,Sunday,55,4,7,13,79,normal
180,12:15:00 PM,13,Friday,162,46,19,2,229,heavy
181,9:15:00 AM,4,Saturday,30,24,13,13,80,normal
182,10:30:00 PM,2,Thursday,12,0,0,12,24,low
183,7:00:00 AM,12,Thursday,125,30,48,1,204,heavy
184,3:45:00 PM,9,Thursday,79,28,35,13,155,high
185,4:45:00 PM,29,Sunday,149,28,20,10,207,heavy
186,5:00:00 AM,6,Monday,81,16,7,14,118,normal
187,6:00:00 AM,7,Tuesday,121,22,30,0,173,heavy
188,6:45:00 PM,13,Friday,65,25,1,1,92,low
189,1:15:00 PM,16,Monday,61,30,5,20,116,normal
190,10:45:00 PM,1,Wednesday,10,3,1,23,37,normal
191,11:30:00 PM,1,Wednesday,11,0,1,23,35,normal
192,3:45:00 PM,25,Wednesday,84,20,25,15,144,normal
193,6:00:00 PM,19,Thursday,121,16,42,8,187,heavy
194,5:45:00 AM,28,Saturday,66,3,9,19,97,normal
195,12:45:00 AM,4,Saturday,18,3,0,19,40,normal
196,4:15:00 PM,26,Thursday,136,10,27,7,180,heavy
197,1:15:00 PM,3,Friday,174,54,25,1,254,heavy
198,10:00:00 PM,17,Tuesday,14,1,1,22,38,normal
199,11:00:00 PM,31,Tuesday,12,2,1,28,43,normal
200,2:00:00 PM,29,Sunday,56,14,38,12,120,high
201,1:45:00 AM,20,Friday,18,1,1,12,32,low
202,9:45:00 PM,18,Wednesday,105,14,16,33,168,heavy
203,7:30:00 PM,15,Sunday,102,25,12,24,163,high
204,7:15:00 AM,4,Saturday,128,31,26,0,185,heavy
205,6:00:00 AM,27,Friday,76,14,1,12,103,low
206,6:45:00 AM,24,Tuesday,120,31,29,5,185,heavy
207,11:45:00 AM,27,Friday,161,53,11,1,226,heavy
208,12:15:00 AM,26,Thursday,18,0,0,31,49,normal
209,5:00:00 AM,24,Tuesday,119,25,10,9,163,normal
210,11:15:00 PM,26,Thursday,17,4,1,25,47,normal
211,8:00:00 PM,5,Sunday,53,19,11,18,101,normal
212,7:45:00 PM,5,Sunday,97,22,17,13,149,normal
213,6:30:00 AM,5,Sunday,119,31,36,5,191,heavy
214,5:15:00 AM,6,Monday,94,1,9,3,107,low
215,4:15:00 AM,26,Thursday,102,20,4,12,138,normal
216,3:45:00 PM,7,Tuesday,114,26,16,20,176,heavy
217,2:45:00 AM,15,Sunday,10,1,1,12,24,low
218,11:45:00 PM,28,Saturday,17,2,0,18,37,normal
219,3:00:00 AM,2,Thursday,13,1,1,13,28,normal
220,5:30:00 PM,19,Thursday,123,36,34,5,198,heavy
221,5:00:00 PM,1,Wednesday,146,18,49,9,222,heavy
222,3:15:00 PM,6,Monday,106,10,9,8,133,normal
223,10:00:00 PM,21,Sunday,11,3,0,34,48,normal
224,3:00:00 PM,4,Saturday,112,16,30,11,169,heavy
225,5:15:00 AM,29,Sunday,66,16,9,19,110,normal
226,6:15:00 AM,4,Saturday,140,35,50,0,225,heavy
227,6:45:00 PM,24,Tuesday,71,17,15,31,134,high
228,3:00:00 AM,23,Monday,20,1,1,16,38,normal
229,12:30:00 PM,15,Sunday,48,8,15,23,94,normal
230,12:00:00 PM,18,Wednesday,35,5,12,20,72,normal
231,2:45:00 PM,7,Tuesday,119,13,32,7,171,heavy
232,7:30:00 AM,10,Tuesday,114,37,21,5,177,heavy
233,7:00:00 AM,5,Sunday,103,27,21,4,155,normal
234,6:45:00 PM,3,Friday,87,21,16,0,124,normal
235,6:15:00 PM,19,Thursday,119,38,47,7,211,heavy
236,3:15:00 PM,2,Thursday,21,15,33,12,81,normal
237,11:45:00 AM,16,Monday,44,9,10,24,87,normal
238,4:30:00 AM,1,Wednesday,78,11,10,18,117,normal
239,5:15:00 AM,16,Monday,111,14,10,14,149,normal
240,11:30:00 AM,12,Thursday,59,9,12,26,106,normal
241,5:30:00 AM,15,Sunday,93,5,4,1,103,low
242,2:30:00 AM,4,Saturday,18,5,0,18,41,normal
243,7:00:00 AM,1,Wednesday,138,21,28,1,188,heavy
244,3:30:00 AM,30,Monday,16,0,0,16,32,normal
245,6:15:00 PM,26,Thursday,120,24,36,5,185,heavy
246,4:15:00 AM,1,Wednesday,56,21,3,0,80,low
247,4:30:00 PM,31,Tuesday,117,28,33,10,188,heavy
248,11:30:00 AM,7,Tuesday,44,5,11,23,83,normal
249,6:00:00 PM,30,Monday,109,21,24,10,164,normal
250,8:15:00 AM,26,Thursday,104,10,48,2,164,high
251,11:15:00 AM,10,Tuesday,58,8,14,29,109,normal
252,2:45:00 AM,19,Thursday,15,4,0,14,33,normal
253,3:45:00 AM,1,Wednesday,14,1,0,12,27,low
254,5:45:00 PM,3,Friday,54,27,21,2,104,normal
255,6:45:00 PM,28,Saturday,66,8,11,9,94,low
256,11:30:00 AM,25,Wednesday,49,10,6,27,92,normal
257,9:30:00 AM,19,Thursday,75,2,18,29,124,high
258,7:45:00 PM,21,Sunday,75,8,16,25,124,high
259,5:15:00 PM,9,Thursday,102,20,31,5,158,high
260,8:00:00 PM,9,Thursday,72,25,10,27,134,high
261,4:30:00 PM,11,Wednesday,142,13,37,8,200,heavy
262,7:15:00 AM,17,Tuesday,117,30,26,5,178,heavy
263,8:45:00 AM,18,Wednesday,141,15,32,4,192,heavy
264,3:15:00 AM,9,Thursday,18,2,0,19,39,normal
265,6:15:00 PM,10,Tuesday,123,10,29,8,170,heavy
266,3:15:00 AM,10,Tuesday,34,0,4,4,42,low
267,10:45:00 AM,4,Saturday,73,12,32,5,122,high
268,7:30:00 AM,20,Friday,75,6,1,10,92,low
269,5:30:00 AM,1,Wednesday,87,24,6,19,136,normal
270,11:15:00 PM,30,Monday,14,1,0,27,42,normal
271,9:15:00 AM,30,Monday,84,24,12,28,148,high
272,8:15:00 PM,13,Friday,28,7,2,4,41,low
273,11:15:00 AM,19,Thursday,49,5,10,21,85,normal
274,9:45:00 PM,22,Saturday,79,22,17,13,131,normal
275,2:45:00 AM,4,Saturday,12,4,0,11,27,low
276,10:45:00 PM,22,Saturday,16,3,1,37,57,normal
277,10:15:00 AM,29,Sunday,26,15,25,6,72,normal
278,3:15:00 AM,21,Sunday,10,0,0,32,42,normal
279,9:00:00 PM,14,Saturday,110,14,17,8,149,normal
280,2:30:00 PM,1,Wednesday,91,22,34,8,155,high
281,10:45:00 PM,8,Wednesday,12,3,0,40,55,normal
282,1:45:00 AM,12,Thursday,18,1,1,16,36,normal
283,6:15:00 PM,2,Thursday,136,32,41,7,216,heavy
284,8:45:00 AM,6,Monday,139,30,35,4,208,heavy
285,11:00:00 PM,1,Wednesday,12,4,0,31,47,normal
286,7:15:00 PM,2,Thursday,63,23,19,34,139,high
287,2:15:00 PM,31,Tuesday,60,19,14,7,100,low
288,9:30:00 PM,22,Saturday,72,10,10,29,121,high
289,5:45:00 PM,28,Saturday,114,32,45,6,197,heavy
290,10:00:00 AM,13,Friday,131,43,20,3,197,heavy
291,5:30:00 AM,14,Saturday,93,17,8,12,130,normal
292,3:00:00 PM,1,Wednesday,108,12,23,8,151,normal
293,6:00:00 AM,10,Tuesday,129,22,42,1,194,heavy
294,12:45:00 PM,3,Friday,136,49,15,1,201,heavy
295,1:45:00 AM,18,Wednesday,15,3,0,35,53,normal
296,11:45:00 PM,21,Sunday,10,2,1,15,28,normal
297,5:45:00 PM,8,Wednesday,137,40,28,9,214,heavy
298,2:00:00 PM,5,Sunday,120,12,40,13,185,heavy
299,11:15:00 AM,23,Monday,25,5,14,26,70,normal
300,1:00:00 PM,29,Sunday,46,6,7,21,80,normal
301,10:30:00 AM,24,Tuesday,64,10,17,23,114,high
302,4:45:00 AM,17,Tuesday,101,3,6,6,116,normal
303,11:30:00 PM,17,Tuesday,12,0,1,34,47,normal
304,3:00:00 AM,31,Tuesday,17,1,0,34,52,normal
305,8:00:00 PM,23,Monday,67,23,14,13,117,normal
306,10:30:00 AM,4,Saturday,72,24,10,9,115,normal
307,8:45:00 PM,12,Thursday,80,14,20,6,120,normal
308,4:45:00 AM,27,Friday,77,8,7,15,107,normal
309,11:30:00 PM,24,Tuesday,16,3,1,26,46,normal
310,4:15:00 PM,24,Tuesday,121,24,31,6,182,heavy
311,1:30:00 AM,23,Monday,13,1,1,16,31,normal
312,11:45:00 PM,26,Thursday,20,0,1,12,33,low
313,9:30:00 AM,22,Saturday,34,5,27,22,88,normal
314,3:00:00 PM,24,Tuesday,47,21,9,18,95,normal
315,9:00:00 AM,15,Sunday,113,35,48,3,199,heavy
316,5:15:00 PM,19,Thursday,147,19,31,8,205,heavy
317,4:45:00 AM,16,Monday,94,4,5,2,105,low
318,1:45:00 AM,14,Saturday,17,1,1,25,44,normal
319,7:30:00 AM,7,Tuesday,142,25,34,5,206,heavy
320,6:30:00 PM,26,Thursday,126,34,38,9,207,heavy
321,12:30:00 AM,14,Saturday,14,0,1,19,34,normal
322,12:15:00 PM,4,Saturday,53,9,15,25,102,normal
323,12:30:00 PM,18,Wednesday,22,9,10,21,62,normal
324,8:15:00 AM,14,Saturday,125,32,38,4,199,heavy
325,11:45:00 AM,26,Thursday,35,7,15,24,81,normal
326,12:00:00 AM,2,Thursday,12,5,1,38,56,normal
327,12:30:00 PM,19,Thursday,66,9,7,24,106,normal
328,1:15:00 AM,16,Monday,14,4,1,28,47,normal
329,8:30:00 AM,17,Tuesday,110,24,26,4,164,high
330,4:00:00 AM,5,Sunday,11,4,0,20,35,normal
331,3:15:00 PM,30,Monday,42,22,5,9,78,low
332,6:45:00 AM,1,Wednesday,101,23,41,5,170,heavy
333,1:00:00 AM,22,Saturday,20,4,1,17,42,normal
334,2:15:00 PM,27,Friday,149,61,16,1,227,heavy
335,3:30:00 PM,22,Saturday,118,15,27,13,173,heavy
336,2:30:00 PM,9,Thursday,60,23,10,20,113,normal
337,2:00:00 AM,7,Tuesday,14,0,1,37,52,normal
338,3:30:00 PM,1,Wednesday,76,28,39,14,157,high
339,5:45:00 PM,19,Thursday,111,24,25,5,165,normal
340,12:45:00 PM,30,Monday,37,9,8,20,74,normal
341,2:15:00 AM,11,Wednesday,14,4,1,10,29,low
342,11:15:00 AM,22,Saturday,63,5,8,23,99,normal
343,1:00:00 AM,20,Friday,12,4,0,29,45,normal
344,4:15:00 PM,29,Sunday,144,28,24,8,204,heavy
345,3:30:00 AM,16,Monday,10,3,1,23,37,normal
346,9:15:00 PM,28,Saturday,79,20,15,18,132,normal
347,4:00:00 PM,24,Tuesday,100,21,45,9,175,heavy
348,3:30:00 PM,19,Thursday,56,29,16,16,117,normal
349,9:45:00 PM,6,Monday,88,15,19,14,136,normal
350,6:45:00 PM,23,Monday,51,8,18,18,95,normal
351,5:30:00 PM,11,Wednesday,118,23,38,10,189,heavy
352,7:30:00 PM,21,Sunday,108,5,15,22,150,high
353,1:15:00 AM,14,Saturday,19,1,0,19,39,normal
354,5:30:00 AM,8,Wednesday,109,0,3,8,120,normal
355,1:30:00 AM,14,Saturday,18,5,0,26,49,normal
356,4:15:00 AM,21,Sunday,97,23,6,17,143,normal
357,9:15:00 AM,21,Sunday,65,19,16,11,111,normal
358,8:00:00 AM,2,Thursday,126,10,26,4,166,high
359,5:15:00 PM,18,Wednesday,104,29,32,7,172,heavy
360,5:15:00 AM,22,Saturday,87,23,5,0,115,normal
361,12:45:00 AM,26,Thursday,13,2,0,32,47,normal
362,8:30:00 PM,1,Wednesday,59,7,15,20,101,normal
363,3:45:00 AM,2,Thursday,19,3,0,13,35,normal
364,3:30:00 AM,6,Monday,20,1,0,29,50,normal
365,1:15:00 PM,13,Friday,156,42,12,3,213,heavy
366,6:45:00 PM,22,Saturday,96,7,13,30,146,high
367,1:00:00 AM,26,Thursday,16,1,0,38,55,normal
368,7:45:00 PM,13,Friday,31,11,1,12,55,low
369,1:15:00 AM,20,Friday,19,4,1,30,54,normal
370,11:00:00 PM,17,Tuesday,13,4,0,28,45,normal
371,1:45:00 AM,22,Saturday,15,0,1,16,32,normal
372,12:15:00 PM,12,Thursday,48,10,9,29,96,normal
373,9:45:00 PM,4,Saturday,106,22,16,18,162,normal
374,12:15:00 AM,3,Friday,11,1,0,27,39,normal
375,9:30:00 AM,1,Wednesday,37,16,13,29,95,normal
376,4:00:00 PM,30,Monday,137,14,41,10,202,heavy
377,2:30:00 AM,27,Friday,12,0,0,11,23,low
378,11:30:00 AM,20,Friday,151,64,16,0,231,heavy
379,10:45:00 PM,10,Tuesday,11,1,0,29,41,normal
380,10:30:00 AM,30,Monday,55,25,33,21,134,high
381,12:00:00 PM,13,Friday,144,68,20,0,232,heavy
382,7:15:00 AM,7,Tuesday,119,39,24,1,183,heavy
383,5:15:00 PM,28,Saturday,125,14,26,5,170,heavy
384,6:00:00 PM,7,Tuesday,144,13,40,10,207,heavy
385,4:45:00 PM,23,Monday,129,10,39,6,184,heavy
386,12:00:00 AM,18,Wednesday,12,3,0,38,53,normal
387,8:30:00 AM,14,Saturday,101,23,38,1,163,high
388,1:45:00 PM,18,Wednesday,100,27,23,16,166,normal
389,3:30:00 PM,25,Wednesday,67,22,7,5,101,low
390,2:45:00 PM,25,Wednesday,97,17,38,20,172,heavy
391,3:15:00 AM,4,Saturday,20,1,0,28,49,normal
392,4:45:00 PM,31,Tuesday,144,36,49,10,239,heavy
393,11:00:00 PM,27,Friday,17,5,1,31,54,normal
394,8:30:00 AM,30,Monday,149,16,49,1,215,heavy
395,7:45:00 AM,18,Wednesday,149,24,33,1,207,heavy
396,11:45:00 AM,2,Thursday,63,5,6,20,94,normal
397,1:45:00 AM,13,Friday,16,2,1,21,40,normal
398,2:15:00 AM,26,Thursday,17,1,1,22,41,normal
399,6:30:00 PM,14,Saturday,117,20,22,9,168,heavy
400,6:00:00 PM,5,Sunday,142,27,30,5,204,heavy
401,5:45:00 AM,4,Saturday,96,7,6,4,113,normal
402,5:30:00 AM,20,Friday,29,12,1,13,55,normal
403,12:30:00 PM,7,Tuesday,20,6,5,27,58,normal
404,7:00:00 PM,25,Wednesday,75,9,14,6,104,low
405,8:45:00 AM,16,Monday,129,24,25,0,178,heavy
406,5:15:00 AM,21,Sunday,77,27,8,10,122,normal
407,9:30:00 AM,29,Sunday,40,14,18,21,93,normal
408,12:45:00 AM,16,Monday,16,4,0,35,55,normal
409,12:30:00 AM,5,Sunday,11,5,0,22,38,normal
410,11:45:00 PM,7,Tuesday,12,3,0,28,43,normal
411,12:45:00 PM,17,Tuesday,34,8,10,23,75,normal
412,4:30:00 PM,14,Saturday,142,23,25,7,197,heavy
413,9:15:00 AM,24,Tuesday,29,10,21,12,72,normal
414,11:00:00 AM,1,Wednesday,32,5,3,21,61,normal
415,9:00:00 PM,6,Monday,105,14,13,32,164,high
416,10:45:00 AM,3,Friday,144,44,16,3,207,heavy
417,2:15:00 PM,30,Monday,40,14,31,19,104,normal
418,12:15:00 PM,30,Monday,48,6,14,28,96,normal
419,3:30:00 AM,28,Saturday,15,0,0,30,45,normal
420,10:30:00 PM,27,Friday,19,0,1,17,37,normal
421,7:00:00 PM,7,Tuesday,56,5,17,14,92,normal
422,2:45:00 AM,31,Tuesday,16,1,0,15,32,normal
423,7:15:00 AM,8,Wednesday,111,18,32,4,165,high
424,5:00:00 PM,31,Tuesday,137,19,23,9,188,heavy
425,8:00:00 AM,17,Tuesday,146,10,30,3,189,heavy
426,12:30:00 PM,26,Thursday,34,8,6,30,78,normal
427,8:30:00 PM,9,Thursday,67,19,11,8,105,low
428,10:45:00 AM,16,Monday,10,7,5,14,36,normal
429,1:30:00 AM,7,Tuesday,19,4,1,21,45,normal
430,2:00:00 AM,2,Thursday,12,3,0,39,54,normal
431,10:15:00 PM,3,Friday,19,3,1,35,58,normal
432,12:00:00 PM,16,Monday,63,8,15,24,110,normal
433,1:30:00 AM,8,Wednesday,18,1,1,25,45,normal
434,7:30:00 PM,23,Monday,50,25,19,9,103,normal
435,5:45:00 AM,30,Monday,106,9,3,10,128,normal
436,6:00:00 AM,28,Saturday,104,32,23,5,164,normal
437,4:30:00 PM,21,Sunday,114,25,21,7,167,normal
438,2:15:00 AM,4,Saturday,10,1,0,11,22,low
439,7:00:00 AM,16,Monday,106,22,37,0,165,high
440,12:15:00 AM,12,Thursday,18,4,0,30,52,normal
441,3:15:00 AM,19,Thursday,12,4,0,31,47,normal
442,12:15:00 PM,7,Tuesday,29,7,3,28,67,normal
443,5:15:00 AM,10,Tuesday,67,29,5,10,111,low
444,9:15:00 PM,4,Saturday,74,19,15,24,132,high
445,6:45:00 PM,6,Monday,73,5,20,10,108,normal
446,5:15:00 PM,15,Sunday,127,36,42,9,214,heavy
447,8:30:00 PM,11,Wednesday,77,7,20,16,120,normal
448,8:30:00 PM,7,Tuesday,54,9,12,10,85,low
449,7:15:00 PM,12,Thursday,103,9,14,29,155,high
450,4:45:00 PM,14,Saturday,111,36,25,6,178,heavy
451,4:30:00 PM,18,Wednesday,118,32,32,10,192,heavy
452,7:45:00 AM,31,Tuesday,146,14,37,2,199,heavy
453,2:00:00 PM,17,Tuesday,82,13,28,5,128,high
454,4:15:00 PM,4,Saturday,100,16,49,7,172,heavy
455,3:45:00 AM,23,Monday,16,1,1,37,55,normal
456,6:30:00 AM,17,Tuesday,150,19,34,4,207,heavy
457,9:30:00 AM,4,Saturday,74,23,35,10,142,high
458,4:30:00 PM,16,Monday,139,11,20,7,177,heavy
459,1:00:00 AM,3,Friday,14,1,1,11,27,low
460,12:00:00 AM,31,Tuesday,18,1,0,30,49,normal
461,6:00:00 AM,18,Wednesday,128,11,46,4,189,heavy
462,12:00:00 AM,15,Sunday,18,5,1,19,43,normal
463,4:45:00 AM,23,Monday,63,25,2,8,98,low
464,1:45:00 AM,4,Saturday,17,5,0,21,43,normal
465,1:30:00 AM,4,Saturday,15,0,0,15,30,normal
466,2:00:00 PM,4,Saturday,73,13,19,9,114,normal
467,2:15:00 PM,1,Wednesday,16,21,10,16,63,normal
468,8:45:00 PM,10,Tuesday,102,6,12,13,133,normal
469,11:15:00 AM,25,Wednesday,38,7,11,20,76,normal
470,12:45:00 AM,17,Tuesday,20,3,1,29,53,normal
471,9:45:00 PM,1,Wednesday,93,8,10,16,127,normal
472,6:00:00 AM,5,Sunday,147,26,44,5,222,heavy
473,1:00:00 PM,13,Friday,136,57,29,4,226,heavy
474,1:45:00 AM,6,Monday,20,0,0,27,47,normal
475,1:45:00 PM,17,Tuesday,42,25,38,18,123,high
476,12:00:00 AM,17,Tuesday,15,2,0,25,42,normal
477,12:45:00 AM,15,Sunday,20,0,1,38,59,normal
478,5:15:00 AM,3,Friday,64,14,1,12,91,low
479,6:30:00 AM,20,Friday,25,9,6,14,54,normal
480,2:30:00 PM,22,Saturday,62,28,18,20,128,normal
481,9:45:00 PM,25,Wednesday,98,13,13,33,157,high
482,12:00:00 AM,11,Wednesday,12,2,1,17,32,normal
483,10:45:00 AM,23,Monday,82,2,40,17,141,high
484,11:45:00 PM,6,Monday,17,1,1,38,57,normal
485,9:30:00 AM,31,Tuesday,62,2,7,22,93,normal
486,8:00:00 PM,4,Saturday,89,25,20,24,158,high
487,1:15:00 AM,24,Tuesday,19,5,1,35,60,normal
488,6:30:00 AM,25,Wednesday,121,27,50,4,202,heavy
489,8:00:00 AM,9,Thursday,101,10,48,5,164,high
490,9:15:00 AM,25,Wednesday,92,10,39,19,160,high
491,2:45:00 PM,10,Tuesday,29,26,5,6,66,low
492,1:30:00 AM,30,Monday,18,4,0,31,53,normal
493,7:45:00 AM,23,Monday,108,40,45,1,194,heavy
494,8:15:00 AM,3,Friday,30,12,1,14,57,normal
495,5:15:00 AM,8,Wednesday,85,9,4,11,109,low
496,7:30:00 PM,6,Monday,99,19,18,24,160,high
497,5:30:00 PM,22,Saturday,133,21,26,5,185,heavy
498,10:30:00 PM,25,Wednesday,18,2,1,34,55,normal
499,1:30:00 PM,27,Friday,144,62,12,3,221,heavy
500,10:45:00 PM,28,Saturday,14,1,1,30,46,normal
501,12:15:00 AM,7,Tuesday,18,4,1,19,42,normal
502,11:00:00 AM,4,Saturday,26,8,8,24,66,normal
503,4:45:00 AM,4,Saturday,109,16,6,12,143,normal
504,10:45:00 AM,27,Friday,156,54,25,3,238,heavy
505,2:00:00 AM,15,Sunday,19,2,1,30,52,normal
506,7:45:00 AM,8,Wednesday,115,34,37,5,191,heavy
507,3:45:00 PM,15,Sunday,49,16,9,12,86,low
508,7:30:00 AM,15,Sunday,122,13,47,3,185,heavy
509,8:00:00 AM,16,Monday,130,40,31,2,203,heavy
510,4:00:00 AM,16,Monday,20,0,1,30,51,normal
511,8:30:00 AM,7,Tuesday,111,17,32,1,161,high
512,9:00:00 AM,25,Wednesday,136,26,20,4,186,heavy
513,8:45:00 PM,21,Sunday,55,9,12,19,95,normal
514,1:00:00 AM,16,Monday,20,2,1,33,56,normal
515,5:45:00 PM,18,Wednesday,107,15,48,5,175,heavy
516,1:30:00 AM,19,Thursday,17,5,0,18,40,normal
517,3:30:00 AM,23,Monday,14,4,1,32,51,normal
518,12:00:00 AM,9,Thursday,14,3,0,28,45,normal
519,8:45:00 AM,22,Saturday,136,36,40,4,216,heavy
520,10:15:00 PM,12,Thursday,20,5,1,36,62,normal
521,6:30:00 AM,28,Saturday,127,24,27,0,178,heavy
522,7:00:00 PM,5,Sunday,102,15,11,29,157,high
523,11:30:00 AM,8,Wednesday,26,7,15,27,75,normal
524,1:45:00 PM,10,Tuesday,59,19,35,16,129,high
525,11:15:00 AM,13,Friday,133,56,25,2,216,heavy
526,1:15:00 PM,5,Sunday,47,24,24,9,104,normal
527,12:00:00 AM,21,Sunday,19,5,1,30,55,normal
528,12:15:00 AM,14,Saturday,14,4,0,34,52,normal
529,11:00:00 PM,7,Tuesday,15,4,1,39,59,normal
530,4:00:00 AM,26,Thursday,14,5,0,39,58,normal
531,7:45:00 AM,2,Thursday,134,12,22,2,170,heavy
532,5:00:00 PM,9,Thursday,113,23,43,6,185,heavy
533,3:45:00 PM,21,Sunday,53,17,26,8,104,normal
534,8:45:00 AM,8,Wednesday,122,29,31,5,187,heavy
535,1:45:00 PM,27,Friday,161,51,20,1,233,heavy
536,2:30:00 PM,29,Sunday,29,18,10,9,66,low
537,7:15:00 AM,20,Friday,27,6,5,15,53,normal
538,9:30:00 PM,3,Friday,22,5,3,13,43,normal
539,12:45:00 AM,31,Tuesday,17,0,1,14,32,normal
540,10:30:00 PM,11,Wednesday,18,2,1,25,46,normal
541,10:15:00 AM,14,Saturday,26,12,14,13,65,normal
542,9:45:00 AM,20,Friday,134,59,11,3,207,heavy
543,5:30:00 PM,1,Wednesday,138,18,27,6,189,heavy
544,8:45:00 AM,20,Friday,66,8,0,12,86,low
545,5:00:00 PM,4,Saturday,117,36,41,10,204,heavy
546,10:15:00 AM,24,Tuesday,64,25,17,20,126,normal
547,1:30:00 AM,5,Sunday,11,4,1,26,42,normal
548,6:15:00 AM,3,Friday,60,11,4,10,85,low
549,9:15:00 AM,2,Thursday,40,20,37,28,125,high
550,10:45:00 AM,12,Thursday,28,7,22,18,75,normal
551,12:15:00 PM,25,Wednesday,58,7,6,27,98,normal
552,7:00:00 PM,17,Tuesday,96,11,15,14,136,normal
553,8:00:00 AM,6,Monday,108,27,44,5,184,heavy
554,8:45:00 PM,6,Monday,85,6,18,17,126,normal
555,8:15:00 PM,31,Tuesday,80,14,20,15,129,normal
556,9:15:00 AM,29,Sunday,39,8,23,13,83,normal
557,3:45:00 AM,14,Saturday,18,5,0,35,58,normal
558,1:00:00 AM,17,Tuesday,17,2,0,24,43,normal
559,7:15:00 PM,5,Sunday,96,22,20,12,150,normal
560,10:45:00 AM,7,Tuesday,72,22,21,27,142,high
561,1:00:00 AM,15,Sunday,20,1,1,24,46,normal
562,6:15:00 AM,7,Tuesday,130,27,39,5,201,heavy
563,8:30:00 PM,8,Wednesday,86,15,15,23,139,high
564,11:30:00 AM,17,Tuesday,65,7,7,22,101,normal
565,7:45:00 AM,24,Tuesday,101,14,24,0,139,normal
566,10:00:00 AM,31,Tuesday,35,22,22,18,97,normal
567,2:45:00 AM,25,Wednesday,12,2,1,35,50,normal
568,10:30:00 PM,30,Monday,15,5,1,14,35,normal
569,5:15:00 PM,8,Wednesday,126,24,31,7,188,heavy
570,11:30:00 AM,16,Monday,50,7,8,21,86,normal
571,12:30:00 PM,8,Wednesday,44,7,9,20,80,normal
572,10:00:00 PM,23,Monday,18,3,0,11,32,low
573,6:45:00 PM,12,Thursday,110,24,10,29,173,heavy
574,4:00:00 AM,6,Monday,18,3,0,22,43,normal
575,2:00:00 AM,10,Tuesday,51,0,9,7,67,low
576,9:00:00 PM,10,Tuesday,91,14,15,6,126,normal
577,4:00:00 PM,25,Wednesday,144,15,42,8,209,heavy
578,9:45:00 AM,13,Friday,171,59,27,3,260,heavy
579,10:45:00 AM,28,Saturday,25,12,13,5,55,low
580,6:30:00 AM,2,Thursday,123,37,34,4,198,heavy
581,6:45:00 AM,19,Thursday,143,22,37,4,206,heavy
582,12:15:00 PM,22,Saturday,65,7,14,25,111,normal
583,4:15:00 AM,22,Saturday,86,28,2,18,134,normal
584,11:00:00 AM,18,Wednesday,43,7,7,29,86,normal
585,12:45:00 AM,13,Friday,10,3,0,12,25,low
586,7:45:00 PM,12,Thursday,51,17,16,8,92,normal
587,4:45:00 PM,2,Thursday,126,15,26,6,173,heavy
588,2:45:00 AM,22,Saturday,20,0,1,33,54,normal
589,5:15:00 PM,31,Tuesday,118,19,48,5,190,heavy
590,5:30:00 AM,2,Thursday,85,27,7,17,136,normal
591,4:15:00 PM,1,Wednesday,115,36,41,8,200,heavy
592,2:15:00 AM,20,Friday,10,2,1,20,33,normal
593,1:00:00 PM,15,Sunday,35,10,5,30,80,normal
594,5:00:00 AM,20,Friday,70,6,7,14,97,normal
595,12:45:00 PM,19,Thursday,46,8,3,22,79,normal
596,12:30:00 AM,21,Sunday,16,3,0,14,33,normal
597,8:00:00 AM,11,Wednesday,125,31,48,4,208,heavy
598,2:00:00 AM,25,Wednesday,15,1,1,15,32,normal
599,1:15:00 PM,22,Saturday,9,27,32,17,85,normal
600,6:15:00 PM,22,Saturday,126,27,44,8,205,heavy
601,11:30:00 AM,31,Tuesday,51,10,14,24,99,normal
602,3:15:00 PM,10,Tuesday,68,28,9,15,120,normal
603,7:00:00 PM,27,Friday,81,22,18,2,123,normal
604,2:30:00 AM,5,Sunday,19,5,1,29,54,normal
605,11:00:00 AM,20,Friday,171,46,15,3,235,heavy
606,5:00:00 AM,13,Friday,58,13,4,15,90,normal
607,8:30:00 PM,24,Tuesday,63,22,12,29,126,high
608,3:45:00 PM,6,Monday,59,29,15,16,119,normal
609,8:15:00 AM,13,Friday,80,16,4,15,115,normal
610,3:45:00 AM,4,Saturday,15,0,0,36,51,normal
611,9:45:00 AM,21,Sunday,98,21,10,5,134,normal
612,6:30:00 AM,9,Thursday,112,26,30,4,172,heavy
613,9:45:00 PM,11,Wednesday,86,13,11,35,145,high
614,7:30:00 PM,4,Saturday,110,10,10,20,150,normal
615,5:00:00 AM,26,Thursday,55,15,1,10,81,low
616,4:15:00 AM,29,Sunday,114,30,9,7,160,normal
617,11:30:00 PM,4,Saturday,17,0,0,31,48,normal
618,7:45:00 AM,19,Thursday,119,40,41,2,202,heavy
619,9:15:00 PM,2,Thursday,102,14,15,34,165,high
620,6:45:00 PM,30,Monday,90,20,11,25,146,high
621,10:45:00 AM,19,Thursday,50,17,38,24,129,high
622,8:00:00 AM,10,Tuesday,122,28,33,1,184,heavy
623,4:30:00 AM,25,Wednesday,89,20,4,17,130,normal
624,7:30:00 AM,3,Friday,72,20,5,15,112,normal
625,10:00:00 PM,5,Sunday,15,1,1,25,42,normal
626,1:00:00 AM,6,Monday,11,1,1,40,53,normal
627,8:30:00 AM,3,Friday,72,8,6,12,98,low
628,5:15:00 PM,1,Wednesday,126,24,48,9,207,heavy
629,8:30:00 PM,22,Saturday,103,14,20,14,151,normal
630,11:45:00 PM,30,Monday,19,0,0,29,48,normal
631,5:45:00 PM,11,Wednesday,121,35,26,8,190,heavy
632,1:00:00 AM,18,Wednesday,15,5,0,21,41,normal
633,4:45:00 AM,30,Monday,74,29,9,4,116,normal
634,8:30:00 AM,22,Saturday,121,14,23,1,159,normal
635,12:45:00 PM,9,Thursday,35,5,15,25,80,normal
636,6:00:00 PM,18,Wednesday,139,25,43,7,214,heavy
637,1:30:00 PM,31,Tuesday,108,17,16,16,157,normal
638,1:30:00 AM,29,Sunday,12,0,0,32,44,normal
639,6:00:00 AM,4,Saturday,102,21,42,3,168,heavy
640,11:15:00 PM,8,Wednesday,18,5,1,15,39,normal
641,8:30:00 PM,20,Friday,30,2,3,1,36,low
642,8:30:00 AM,5,Sunday,143,12,23,3,181,heavy
643,1:00:00 PM,27,Friday,132,58,15,4,209,heavy
644,11:15:00 AM,6,Monday,24,8,3,20,55,normal
645,1:00:00 AM,8,Wednesday,12,2,1,17,32,normal
646,3:15:00 AM,20,Friday,12,2,0,40,54,normal
647,5:15:00 PM,26,Thursday,136,29,29,10,204,heavy
648,7:45:00 PM,6,Monday,54,17,14,8,93,low
649,1:00:00 AM,21,Sunday,20,0,1,17,38,normal
650,9:00:00 AM,29,Sunday,117,14,39,0,170,heavy
651,7:45:00 PM,17,Tuesday,66,6,12,33,117,high
652,1:00:00 PM,20,Friday,132,68,22,4,226,heavy
653,6:15:00 AM,12,Thursday,114,32,34,2,182,heavy
654,11:00:00 AM,24,Tuesday,59,9,9,21,98,normal
655,7:45:00 AM,11,Wednesday,125,29,29,3,186,heavy
656,3:15:00 AM,23,Monday,16,1,1,15,33,normal
657,1:15:00 AM,4,Saturday,14,2,1,22,39,normal
658,5:45:00 PM,7,Tuesday,105,13,48,10,176,heavy
659,12:00:00 AM,12,Thursday,18,1,1,39,59,normal
660,4:00:00 AM,3,Friday,20,0,0,12,32,low
661,4:45:00 PM,10,Tuesday,124,11,30,7,172,heavy
662,3:30:00 PM,23,Monday,45,17,7,6,75,low
663,12:00:00 AM,22,Saturday,10,3,0,33,46,normal
664,5:00:00 PM,20,Friday,55,28,5,0,88,low
665,6:15:00 PM,9,Thursday,130,24,48,9,211,heavy
666,4:30:00 AM,11,Wednesday,109,25,3,8,145,normal
667,1:15:00 PM,15,Sunday,112,15,40,10,177,heavy
668,9:15:00 PM,19,Thursday,110,6,14,23,153,high
669,1:00:00 AM,12,Thursday,18,0,0,13,31,normal
670,4:15:00 AM,18,Wednesday,119,12,6,4,141,normal
671,1:30:00 PM,24,Tuesday,108,21,37,14,180,heavy
672,8:15:00 AM,6,Monday,109,19,49,3,180,heavy
673,3:30:00 AM,14,Saturday,13,5,0,31,49,normal
674,9:45:00 AM,16,Monday,31,7,34,24,96,normal
675,3:30:00 AM,26,Thursday,19,1,0,20,40,normal
676,2:00:00 PM,9,Thursday,70,28,12,12,122,normal
677,8:30:00 PM,21,Sunday,84,25,20,30,159,high
678,2:30:00 AM,7,Tuesday,13,1,0,19,33,normal
679,5:30:00 PM,23,Monday,123,10,30,7,170,heavy
680,11:15:00 AM,4,Saturday,47,5,7,28,87,normal
681,10:15:00 PM,15,Sunday,17,2,1,30,50,normal
682,2:45:00 AM,24,Tuesday,14,4,1,21,40,normal
683,8:30:00 PM,3,Friday,40,6,1,3,50,low
684,6:15:00 AM,2,Thursday,133,40,37,0,210,heavy
685,5:45:00 PM,6,Monday,109,37,44,9,199,heavy
686,2:30:00 AM,31,Tuesday,19,4,0,16,39,normal
687,8:00:00 AM,8,Wednesday,135,35,38,3,211,heavy
688,5:00:00 AM,27,Friday,80,18,6,11,115,normal
689,9:00:00 PM,15,Sunday,96,9,18,25,148,high
690,3:00:00 PM,25,Wednesday,92,18,31,6,147,high
691,2:15:00 AM,14,Saturday,15,5,0,15,35,normal
692,10:00:00 PM,24,Tuesday,16,1,1,26,44,normal
693,9:15:00 PM,3,Friday,33,4,4,5,46,low
694,6:00:00 PM,12,Thursday,112,11,50,5,178,heavy
695,6:15:00 PM,23,Monday,139,15,43,9,206,heavy
696,9:45:00 AM,12,Thursday,16,22,12,20,70,normal
697,2:45:00 AM,12,Thursday,18,0,0,27,45,normal
698,5:00:00 PM,13,Friday,66,26,4,1,97,low
699,7:30:00 AM,14,Saturday,109,29,23,5,166,normal
700,1:30:00 PM,30,Monday,63,12,22,5,102,normal
701,5:30:00 AM,10,Tuesday,56,12,2,14,84,normal
702,7:30:00 PM,17,Tuesday,76,22,10,9,117,normal
703,7:30:00 AM,13,Friday,30,9,3,10,52,low
704,7:15:00 AM,24,Tuesday,139,40,48,2,229,heavy
705,7:45:00 AM,1,Wednesday,108,30,46,5,189,heavy
706,8:45:00 PM,27,Friday,45,6,6,10,67,low
707,8:30:00 AM,8,Wednesday,124,11,27,2,164,high
708,3:30:00 AM,20,Friday,16,0,1,37,54,normal
709,10:30:00 PM,19,Thursday,12,4,1,18,35,normal
710,7:00:00 AM,19,Thursday,113,38,50,3,204,heavy
711,6:00:00 PM,17,Tuesday,118,40,29,10,197,heavy
712,8:00:00 AM,3,Friday,54,10,4,14,82,normal
713,2:15:00 AM,22,Saturday,11,3,1,39,54,normal
714,11:15:00 PM,9,Thursday,15,4,1,25,45,normal
715,3:00:00 AM,30,Monday,10,5,0,33,48,normal
716,12:15:00 PM,16,Monday,56,6,6,29,97,normal
717,3:45:00 PM,11,Wednesday,68,26,25,20,139,normal
718,6:00:00 AM,17,Tuesday,106,13,39,1,159,high
719,7:30:00 AM,1,Wednesday,123,19,25,5,172,heavy
720,6:00:00 PM,6,Monday,145,27,35,7,214,heavy
721,8:00:00 PM,1,Wednesday,90,7,17,31,145,high
722,10:15:00 PM,21,Sunday,15,5,0,14,34,normal
723,2:30:00 PM,31,Tuesday,102,11,9,11,133,normal
724,7:30:00 PM,31,Tuesday,95,9,19,7,130,normal
725,2:15:00 AM,30,Monday,13,0,0,26,39,normal
726,4:00:00 AM,7,Tuesday,19,2,0,32,53,normal
727,4:15:00 PM,27,Friday,61,26,8,0,95,low
728,1:30:00 AM,31,Tuesday,10,2,0,18,30,normal
729,1:00:00 PM,3,Friday,147,52,26,0,225,heavy
730,11:00:00 PM,28,Saturday,17,0,1,12,30,low
731,2:30:00 AM,26,Thursday,12,3,0,29,44,normal
732,3:30:00 AM,3,Friday,18,4,0,30,52,normal
733,11:45:00 PM,4,Saturday,18,1,0,16,35,normal
734,9:00:00 AM,22,Saturday,114,21,23,1,159,normal
735,2:45:00 AM,14,Saturday,14,3,1,18,36,normal
736,7:15:00 AM,21,Sunday,139,38,49,2,228,heavy
737,4:30:00 AM,31,Tuesday,65,10,3,8,86,low
738,2:30:00 AM,9,Thursday,12,3,0,17,32,normal
739,5:15:00 AM,5,Sunday,99,6,6,7,118,normal
740,4:00:00 AM,18,Wednesday,18,5,1,30,54,normal
741,11:30:00 AM,9,Thursday,21,7,9,20,57,normal
742,4:00:00 PM,6,Monday,139,25,41,5,210,heavy
743,10:30:00 AM,23,Monday,69,15,24,20,128,normal
744,2:45:00 AM,30,Monday,15,4,0,12,31,low
745,3:15:00 AM,8,Wednesday,16,1,0,11,28,low
746,7:15:00 PM,30,Monday,60,21,13,6,100,low
747,3:00:00 PM,20,Friday,140,70,23,4,237,heavy
748,6:15:00 PM,24,Tuesday,102,27,32,5,166,high
749,5:30:00 AM,26,Thursday,52,13,5,15,85,normal
750,3:30:00 PM,11,Wednesday,109,30,22,20,181,heavy
751,9:00:00 AM,24,Tuesday,116,24,32,5,177,heavy
752,10:15:00 AM,5,Sunday,92,3,33,21,149,high
753,5:30:00 PM,27,Friday,63,28,22,0,113,normal
754,9:45:00 PM,30,Monday,63,15,11,23,112,high
755,12:45:00 AM,24,Tuesday,15,0,0,28,43,normal
756,11:30:00 PM,22,Saturday,20,3,0,25,48,normal
757,7:30:00 PM,11,Wednesday,108,15,10,6,139,normal
758,12:00:00 PM,4,Saturday,36,5,14,22,77,normal
759,5:00:00 AM,15,Sunday,75,1,8,10,94,low
760,9:15:00 PM,6,Monday,96,21,11,24,152,high
761,2:00:00 PM,26,Thursday,60,18,21,10,109,normal
762,3:15:00 AM,28,Saturday,19,0,0,17,36,normal
763,12:45:00 PM,10,Tuesday,24,9,14,23,70,normal
764,9:30:00 PM,16,Monday,54,20,10,9,93,low
765,6:30:00 PM,19,Thursday,132,30,41,6,209,heavy
766,11:00:00 PM,5,Sunday,14,0,0,28,42,normal
767,1:45:00 PM,9,Thursday,62,23,38,19,142,high
768,9:45:00 AM,8,Wednesday,32,10,33,8,83,normal
769,9:30:00 PM,8,Wednesday,89,25,13,23,150,high
770,10:45:00 AM,2,Thursday,17,13,13,27,70,normal
771,6:00:00 PM,4,Saturday,134,35,26,7,202,heavy
772,2:15:00 AM,15,Sunday,18,1,0,16,35,normal
773,8:00:00 AM,4,Saturday,148,37,46,2,233,heavy
774,12:00:00 PM,5,Sunday,38,6,6,24,74,normal
775,3:30:00 AM,21,Sunday,14,1,1,12,28,low
776,11:15:00 PM,1,Wednesday,20,1,1,24,46,normal
777,7:30:00 PM,27,Friday,21,5,6,15,47,normal
778,1:45:00 PM,7,Tuesday,98,29,34,12,173,heavy
779,5:00:00 AM,23,Monday,72,7,1,4,84,low
780,5:00:00 PM,19,Thursday,118,32,48,6,204,heavy
781,10:15:00 AM,19,Thursday,74,21,29,26,150,high
782,7:30:00 PM,22,Saturday,72,6,19,8,105,normal
783,10:15:00 AM,27,Friday,134,45,22,3,204,heavy
784,5:30:00 PM,30,Monday,135,18,20,5,178,heavy
785,1:15:00 PM,7,Tuesday,99,21,21,6,147,normal
786,6:15:00 AM,22,Saturday,148,35,46,1,230,heavy
787,4:30:00 AM,10,Tuesday,65,24,7,16,112,normal
788,4:00:00 AM,1,Wednesday,16,4,0,18,38,normal
789,2:00:00 PM,15,Sunday,63,22,18,15,118,normal
790,9:15:00 AM,23,Monday,73,9,35,12,129,high
791,7:00:00 PM,11,Wednesday,107,15,10,15,147,normal
792,10:15:00 PM,24,Tuesday,12,1,0,12,25,low
793,12:00:00 PM,7,Tuesday,20,6,6,23,55,normal
794,10:45:00 AM,25,Wednesday,11,25,30,22,88,normal
795,11:00:00 AM,17,Tuesday,41,5,4,24,74,normal
796,5:45:00 PM,21,Sunday,122,40,48,10,220,heavy
797,10:15:00 AM,2,Thursday,48,9,30,14,101,normal
798,1:45:00 AM,31,Tuesday,13,3,0,31,47,normal
799,4:00:00 PM,9,Thursday,146,25,33,8,212,heavy
800,8:15:00 PM,10,Tuesday,62,12,14,19,107,normal
801,4:15:00 AM,11,Wednesday,104,6,5,1,116,normal
802,12:30:00 AM,15,Sunday,13,0,1,12,26,low
803,6:00:00 AM,9,Thursday,141,30,31,1,203,heavy
804,11:45:00 AM,11,Wednesday,51,7,14,20,92,normal
805,4:15:00 AM,30,Monday,82,20,10,11,123,normal
806,9:15:00 PM,5,Sunday,78,16,13,27,134,high
807,8:15:00 PM,24,Tuesday,87,17,18,7,129,normal
808,1:30:00 PM,14,Saturday,120,28,22,20,190,heavy
809,4:15:00 AM,2,Thursday,54,15,10,8,87,low
810,12:45:00 PM,1,Wednesday,34,6,12,27,79,normal
811,11:45:00 AM,21,Sunday,61,7,15,28,111,normal
812,7:45:00 PM,19,Thursday,66,11,18,34,129,high
813,12:00:00 AM,1,Wednesday,14,0,0,34,48,normal
814,7:00:00 AM,27,Friday,38,7,1,13,59,normal
815,10:00:00 PM,25,Wednesday,13,5,0,18,36,normal
816,6:45:00 AM,3,Friday,75,20,6,15,116,normal
817,2:30:00 AM,19,Thursday,14,3,1,26,44,normal
818,9:00:00 PM,17,Tuesday,77,15,12,29,133,high
819,4:30:00 AM,14,Saturday,76,10,7,9,102,low
820,5:15:00 AM,4,Saturday,90,24,8,20,142,normal
821,1:45:00 PM,8,Wednesday,109,21,10,12,152,normal
822,10:30:00 AM,3,Friday,141,51,27,3,222,heavy
823,8:45:00 PM,3,Friday,45,2,7,7,61,low
824,6:45:00 AM,6,Monday,122,30,37,2,191,heavy
825,7:00:00 AM,14,Saturday,110,39,38,5,192,heavy
826,8:00:00 AM,18,Wednesday,140,40,36,1,217,heavy
827,7:15:00 PM,9,Thursday,108,24,19,10,161,normal
828,11:30:00 PM,14,Saturday,14,5,1,12,32,low
829,4:30:00 AM,9,Thursday,71,22,5,2,100,low
830,10:15:00 PM,8,Wednesday,14,5,1,20,40,normal
831,6:00:00 AM,19,Thursday,107,26,31,2,166,high
832,12:00:00 PM,28,Saturday,41,7,5,26,79,normal
833,11:15:00 PM,5,Sunday,13,2,0,22,37,normal
834,7:15:00 PM,16,Monday,104,12,10,10,136,normal
835,5:45:00 AM,3,Friday,53,8,4,15,80,normal
836,7:45:00 AM,6,Monday,131,26,40,1,198,heavy
837,4:45:00 AM,19,Thursday,92,26,8,7,133,normal
838,8:30:00 AM,6,Monday,125,15,28,3,171,heavy
839,11:15:00 PM,23,Monday,12,3,1,13,29,normal
840,12:15:00 PM,19,Thursday,47,8,3,25,83,normal
841,5:00:00 PM,21,Sunday,149,22,37,8,216,heavy
842,3:30:00 AM,27,Friday,15,4,1,17,37,normal
843,3:45:00 PM,28,Saturday,68,19,15,11,113,normal
844,3:45:00 AM,6,Monday,16,4,0,24,44,normal
845,9:00:00 PM,13,Friday,43,9,1,11,64,low
846,7:00:00 PM,3,Friday,71,26,19,1,117,normal
847,11:45:00 AM,10,Tuesday,47,9,6,29,91,normal
848,8:00:00 PM,11,Wednesday,101,6,15,13,135,normal
849,7:30:00 PM,18,Wednesday,84,10,16,20,130,normal
850,8:45:00 AM,7,Tuesday,144,26,50,3,223,normal
851,9:45:00 AM,27,Friday,149,41,23,3,216,heavy
852,12:15:00 PM,11,Wednesday,51,10,6,22,89,normal
853,8:45:00 AM,5,Sunday,143,40,30,0,213,heavy
854,11:45:00 PM,12,Thursday,16,3,0,33,52,normal
855,4:30:00 PM,5,Sunday,119,37,22,8,186,heavy
856,4:15:00 AM,19,Thursday,115,16,10,13,154,normal
857,2:00:00 PM,28,Saturday,46,20,18,5,89,normal
858,6:15:00 AM,20,Friday,35,11,5,11,62,low
859,11:30:00 AM,29,Sunday,23,6,15,20,64,normal
860,7:45:00 PM,9,Thursday,102,22,17,10,151,normal
861,8:45:00 PM,25,Wednesday,69,11,12,8,100,low
862,4:30:00 AM,6,Monday,114,5,9,7,135,normal
863,11:15:00 AM,31,Tuesday,55,5,5,21,86,normal
864,12:00:00 PM,21,Sunday,56,5,4,29,94,normal
865,4:30:00 PM,17,Tuesday,123,28,24,10,185,heavy
866,5:30:00 AM,24,Tuesday,102,24,3,16,145,normal
867,8:45:00 PM,8,Wednesday,91,18,19,26,154,high
868,2:30:00 PM,17,Tuesday,39,25,33,9,106,normal
869,6:45:00 PM,31,Tuesday,78,6,11,28,123,high
870,4:30:00 AM,26,Thursday,92,4,6,18,120,normal
871,12:15:00 PM,17,Tuesday,38,5,8,28,79,normal
872,7:15:00 PM,14,Saturday,100,22,14,8,144,normal
873,10:00:00 PM,11,Wednesday,18,4,0,16,38,normal
874,12:30:00 PM,11,Wednesday,51,8,11,22,92,normal
875,6:15:00 PM,29,Sunday,127,40,39,8,214,heavy
876,7:00:00 PM,31,Tuesday,102,23,16,24,165,high
877,5:45:00 PM,14,Saturday,140,22,27,5,194,heavy
878,12:45:00 AM,18,Wednesday,12,4,1,27,44,normal
879,1:00:00 PM,8,Wednesday,27,6,14,30,77,normal
880,5:30:00 AM,22,Saturday,88,5,8,13,114,normal
881,9:45:00 AM,26,Thursday,85,3,14,16,118,normal
882,4:15:00 PM,21,Sunday,142,24,39,9,214,heavy
883,5:45:00 PM,10,Tuesday,145,18,40,9,212,heavy
884,7:45:00 PM,25,Wednesday,50,7,13,30,100,normal
885,5:00:00 PM,3,Friday,79,26,21,2,128,normal
886,8:15:00 AM,2,Thursday,136,22,31,0,189,heavy
887,12:30:00 PM,27,Friday,143,68,16,0,227,heavy
888,4:30:00 PM,15,Sunday,131,14,43,7,195,heavy
889,3:00:00 PM,11,Wednesday,39,24,13,11,87,low
890,12:00:00 PM,9,Thursday,29,9,12,21,71,normal
891,5:45:00 AM,7,Tuesday,120,10,3,16,149,normal
892,7:45:00 PM,31,Tuesday,105,13,12,20,150,normal
893,10:00:00 PM,26,Thursday,17,5,1,16,39,normal
894,5:30:00 PM,31,Tuesday,119,27,28,8,182,heavy
895,10:15:00 PM,4,Saturday,12,4,1,33,50,normal
896,1:00:00 PM,14,Saturday,68,6,12,24,110,normal
897,3:15:00 AM,26,Thursday,12,0,1,33,46,normal
898,1:45:00 AM,21,Sunday,19,1,0,14,34,normal
899,3:00:00 PM,8,Wednesday,74,23,13,20,130,normal
900,2:15:00 PM,2,Thursday,70,13,12,10,105,low
901,8:45:00 AM,17,Tuesday,111,33,31,2,177,heavy
902,12:15:00 AM,20,Friday,14,4,1,12,31,low
903,4:30:00 AM,17,Tuesday,50,13,2,14,79,normal
904,4:30:00 PM,1,Wednesday,142,23,23,6,194,heavy
905,12:15:00 PM,23,Monday,67,10,7,25,109,normal
906,8:30:00 PM,14,Saturday,73,15,18,7,113,normal
907,9:00:00 AM,5,Sunday,128,16,34,0,178,heavy
908,6:45:00 AM,27,Friday,80,16,0,10,106,low
909,10:15:00 PM,29,Sunday,20,2,0,29,51,normal
910,12:00:00 PM,1,Wednesday,45,5,5,24,79,normal
911,5:45:00 PM,2,Thursday,148,23,27,5,203,heavy
912,11:00:00 PM,18,Wednesday,20,1,0,27,48,normal
913,2:00:00 PM,1,Wednesday,50,23,21,11,105,normal
914,6:45:00 AM,13,Friday,32,9,3,11,55,low
915,9:30:00 AM,6,Monday,79,1,10,30,120,high
916,3:15:00 AM,14,Saturday,17,5,0,29,51,normal
917,11:45:00 AM,7,Tuesday,27,6,13,30,76,normal
918,9:30:00 AM,8,Wednesday,100,13,23,9,145,normal
919,4:00:00 AM,9,Thursday,12,0,1,16,29,normal
920,11:45:00 AM,6,Monday,20,7,8,26,61,normal
921,7:45:00 PM,23,Monday,86,24,20,34,164,high
922,6:00:00 PM,9,Thursday,139,33,41,7,220,heavy
923,11:30:00 AM,4,Saturday,33,10,6,29,78,normal
924,12:00:00 AM,4,Saturday,13,2,0,25,40,normal
925,4:45:00 AM,9,Thursday,108,4,5,3,120,normal
926,12:30:00 PM,31,Tuesday,38,10,9,24,81,normal
927,1:15:00 AM,25,Wednesday,16,4,1,39,60,normal
928,9:30:00 AM,25,Wednesday,82,7,13,19,121,normal
929,5:30:00 PM,6,Monday,127,21,28,5,181,heavy
930,7:00:00 PM,12,Thursday,60,15,12,25,112,high
931,7:30:00 PM,8,Wednesday,56,14,14,31,115,high
932,4:00:00 AM,12,Thursday,18,5,1,30,54,normal
933,1:15:00 PM,12,Thursday,45,26,29,10,110,normal
934,2:30:00 PM,27,Friday,158,46,20,1,225,heavy
935,10:30:00 AM,20,Friday,176,45,22,2,245,heavy
936,4:45:00 AM,10,Tuesday,94,27,7,16,144,normal
937,11:45:00 AM,12,Thursday,24,10,5,21,60,normal
938,1:00:00 PM,2,Thursday,26,6,9,29,70,normal
939,5:30:00 PM,20,Friday,76,22,14,2,114,normal
940,6:30:00 AM,26,Thursday,133,19,28,5,185,heavy
941,12:00:00 PM,12,Thursday,41,7,7,21,76,normal
942,4:30:00 PM,23,Monday,120,29,37,6,192,heavy
943,12:30:00 PM,17,Tuesday,59,7,15,23,104,normal
944,8:45:00 PM,20,Friday,48,10,4,2,64,low
945,8:00:00 AM,12,Thursday,147,31,20,4,202,heavy
946,5:00:00 AM,17,Tuesday,94,15,2,9,120,normal
947,10:15:00 PM,31,Tuesday,17,5,0,14,36,normal
948,11:15:00 PM,10,Tuesday,15,0,1,11,27,low
949,3:15:00 PM,28,Saturday,80,26,35,6,147,high
950,3:00:00 PM,13,Friday,148,64,27,0,239,heavy
951,8:00:00 PM,21,Sunday,96,15,12,27,150,high
952,11:00:00 AM,5,Sunday,37,5,12,29,83,normal
953,4:30:00 PM,25,Wednesday,108,10,36,6,160,high
954,10:00:00 AM,29,Sunday,38,12,35,25,110,normal
955,12:30:00 AM,7,Tuesday,19,3,0,24,46,normal
956,3:00:00 AM,5,Sunday,16,4,0,29,49,normal
957,7:15:00 AM,14,Saturday,149,20,39,5,213,heavy
958,7:15:00 AM,16,Monday,147,26,40,0,213,heavy
959,2:15:00 PM,29,Sunday,19,26,36,17,98,normal
960,1:00:00 AM,19,Thursday,16,3,0,15,34,normal
961,10:00:00 AM,22,Saturday,65,10,6,27,108,normal
962,3:30:00 PM,27,Friday,64,23,21,1,109,normal
963,3:45:00 PM,17,Tuesday,78,18,30,8,134,high
964,3:45:00 AM,5,Sunday,16,4,1,28,49,normal
965,7:00:00 PM,14,Saturday,65,15,15,8,103,low
966,6:00:00 PM,3,Friday,53,22,13,2,90,low
967,6:15:00 PM,21,Sunday,112,12,41,5,170,heavy
968,2:30:00 PM,5,Sunday,89,24,12,6,131,normal
969,3:45:00 PM,8,Wednesday,59,25,9,20,113,normal
970,10:45:00 PM,6,Monday,19,5,0,37,61,normal
971,10:30:00 PM,31,Tuesday,15,5,0,18,38,normal
972,3:15:00 AM,3,Friday,20,3,1,26,50,normal
973,12:30:00 PM,3,Friday,162,51,13,0,226,heavy
974,1:45:00 AM,28,Saturday,16,3,0,34,53,normal
975,5:00:00 PM,30,Monday,105,38,34,7,184,heavy
976,2:30:00 AM,14,Saturday,11,4,0,14,29,normal
977,12:30:00 AM,11,Wednesday,16,1,0,14,31,normal
978,8:30:00 AM,24,Tuesday,114,27,45,4,190,heavy
979,3:15:00 AM,1,Wednesday,15,5,1,32,53,normal
980,11:00:00 AM,2,Thursday,36,5,14,25,80,normal
981,5:45:00 AM,2,Thursday,95,5,9,20,129,normal
982,1:30:00 AM,15,Sunday,12,3,1,35,51,normal
983,12:00:00 PM,22,Saturday,57,8,10,22,97,normal
984,2:45:00 AM,23,Monday,10,0,0,22,32,normal
985,2:15:00 AM,5,Sunday,11,1,1,29,42,normal
986,9:00:00 AM,1,Wednesday,149,26,46,1,222,heavy
987,4:45:00 AM,6,Monday,103,3,9,17,132,normal
988,3:30:00 AM,24,Tuesday,10,0,0,11,21,low
989,6:00:00 PM,15,Sunday,138,29,42,9,218,heavy
990,12:45:00 PM,29,Sunday,66,7,15,26,114,high
991,4:15:00 AM,24,Tuesday,73,12,5,5,95,low
992,11:30:00 PM,27,Friday,11,1,0,38,50,normal
993,9:45:00 PM,20,Friday,25,6,3,9,43,low
994,3:45:00 PM,31,Tuesday,44,19,17,9,89,normal
995,5:30:00 PM,24,Tuesday,132,17,36,5,190,heavy
996,8:15:00 PM,19,Thursday,56,23,10,18,107,normal
997,4:45:00 AM,13,Friday,63,6,7,10,86,low
998,7:15:00 AM,12,Thursday,103,27,45,1,176,heavy
999,8:30:00 PM,16,Monday,95,9,16,29,149,high
1000,6:30:00 AM,1,Wednesday,135,19,48,5,207,heavy
1001,9:30:00 PM,5,Sunday,66,12,16,33,127,high
1002,12:00:00 PM,31,Tuesday,25,7,5,20,57,normal
1003,9:45:00 AM,31,Tuesday,92,8,11,21,132,high
1004,1:15:00 PM,28,Saturday,19,26,32,18,95,normal
1005,7:15:00 PM,17,Tuesday,58,11,14,24,107,normal
1006,6:30:00 PM,17,Tuesday,117,29,29,9,184,heavy
1007,3:30:00 PM,31,Tuesday,86,13,27,11,137,high
1008,1:15:00 AM,28,Saturday,11,4,1,22,38,normal
1009,1:15:00 PM,1,Wednesday,64,19,22,12,117,normal
1010,7:30:00 PM,13,Friday,42,10,3,1,56,low
1011,12:45:00 AM,5,Sunday,12,2,1,37,52,normal
1012,4:45:00 PM,11,Wednesday,108,23,26,9,166,high
1013,5:30:00 AM,5,Sunday,108,14,6,9,137,normal
1014,6:45:00 PM,20,Friday,65,20,2,0,87,low
1015,3:15:00 AM,13,Friday,19,3,0,21,43,normal
1016,4:15:00 PM,19,Thursday,104,31,37,6,178,heavy
1017,9:00:00 AM,11,Wednesday,125,28,36,0,189,heavy
1018,1:30:00 PM,15,Sunday,51,21,25,13,110,normal
1019,10:45:00 PM,17,Tuesday,19,0,1,22,42,normal
1020,5:15:00 AM,12,Thursday,102,24,4,20,150,normal
1021,5:30:00 PM,28,Saturday,118,28,23,8,177,heavy
1022,4:00:00 PM,11,Wednesday,142,22,37,6,207,heavy
1023,6:45:00 PM,2,Thursday,87,18,13,34,152,high
1024,7:00:00 PM,26,Thursday,99,9,15,29,152,high
1025,10:45:00 AM,15,Sunday,46,5,34,9,94,normal
1026,1:15:00 AM,8,Wednesday,17,4,1,15,37,normal
1027,4:45:00 PM,18,Wednesday,142,34,38,9,223,normal
1028,1:15:00 PM,20,Friday,161,50,10,0,221,heavy
1029,2:30:00 PM,11,Wednesday,101,23,8,20,152,normal
1030,5:15:00 AM,9,Thursday,62,12,3,18,95,normal
1031,2:00:00 AM,16,Monday,18,3,1,26,48,normal
1032,3:30:00 AM,17,Tuesday,19,2,0,20,41,normal
1033,5:30:00 PM,4,Saturday,101,20,21,9,151,normal
1034,5:30:00 PM,12,Thursday,116,25,33,8,182,heavy
1035,12:45:00 PM,23,Monday,44,8,4,29,85,normal
1036,4:15:00 AM,10,Tuesday,67,11,10,16,104,normal
1037,4:45:00 AM,1,Wednesday,82,29,0,20,131,normal
1038,2:15:00 PM,5,Sunday,66,14,21,7,108,normal
1039,7:15:00 PM,3,Friday,32,5,5,13,55,normal
1040,3:15:00 AM,5,Sunday,19,4,1,33,57,normal
1041,4:45:00 AM,25,Wednesday,120,18,6,13,157,normal
1042,10:30:00 PM,8,Wednesday,18,3,0,24,45,normal
1043,10:45:00 PM,21,Sunday,19,2,1,34,56,normal
1044,8:45:00 AM,2,Thursday,106,12,28,4,150,high
1045,10:00:00 PM,2,Thursday,15,4,1,21,41,normal
1046,6:15:00 PM,11,Wednesday,132,12,27,8,179,heavy
1047,1:00:00 PM,21,Sunday,30,7,3,30,70,normal
1048,4:45:00 AM,31,Tuesday,98,17,0,20,135,normal
1049,9:45:00 AM,14,Saturday,31,2,29,27,89,normal
1050,2:30:00 PM,3,Friday,153,59,20,4,236,heavy
1051,11:15:00 PM,17,Tuesday,13,1,0,26,40,normal
1052,8:45:00 AM,15,Sunday,118,36,37,0,191,heavy
1053,6:15:00 AM,8,Wednesday,108,39,34,5,186,heavy
1054,11:30:00 PM,10,Tuesday,14,1,0,33,48,normal
1055,11:45:00 PM,25,Wednesday,16,4,1,30,51,normal
1056,7:45:00 AM,26,Thursday,150,10,26,0,186,heavy
1057,6:15:00 AM,5,Sunday,139,27,29,1,196,heavy
1058,2:45:00 PM,20,Friday,134,67,12,1,214,heavy
1059,9:30:00 PM,28,Saturday,70,20,11,14,115,normal
1060,4:15:00 PM,23,Monday,113,21,26,5,165,high
1061,7:15:00 PM,6,Monday,89,8,10,19,126,normal
1062,5:45:00 AM,14,Saturday,115,27,9,16,167,normal
1063,7:30:00 AM,24,Tuesday,116,23,23,4,166,normal
1064,10:15:00 AM,20,Friday,173,64,10,2,249,heavy
1065,10:15:00 AM,15,Sunday,63,5,23,12,103,normal
1066,2:45:00 PM,18,Wednesday,74,27,34,10,145,high
1067,12:45:00 AM,22,Saturday,10,1,1,34,46,normal
1068,4:45:00 AM,20,Friday,74,11,5,15,105,normal
1069,4:15:00 AM,4,Saturday,74,4,4,13,95,normal
1070,11:45:00 AM,28,Saturday,53,8,6,23,90,normal
1071,8:00:00 PM,14,Saturday,50,12,15,18,95,normal
1072,3:15:00 PM,18,Wednesday,84,30,26,10,150,high
1073,3:00:00 PM,12,Thursday,86,28,13,5,132,normal
1074,1:30:00 AM,16,Monday,11,4,1,19,35,normal
1075,5:00:00 AM,28,Saturday,74,24,10,20,128,normal
1076,10:00:00 PM,14,Saturday,10,1,0,33,44,normal
1077,9:30:00 PM,17,Tuesday,103,12,15,10,140,normal
1078,3:00:00 PM,27,Friday,134,65,10,2,211,heavy
1079,12:45:00 AM,14,Saturday,19,3,0,36,58,normal
1080,9:00:00 AM,27,Friday,42,9,2,13,66,normal
1081,4:00:00 AM,23,Monday,10,2,1,36,49,normal
1082,2:00:00 PM,16,Monday,25,30,31,9,95,normal
1083,12:30:00 PM,23,Monday,20,8,14,30,72,normal
1084,10:45:00 PM,13,Friday,18,3,0,18,39,normal
1085,3:45:00 PM,14,Saturday,79,13,28,7,127,high
1086,7:00:00 PM,6,Monday,83,11,14,33,141,high
1087,7:30:00 PM,5,Sunday,110,24,15,14,163,normal
1088,1:00:00 AM,25,Wednesday,20,0,0,10,30,low
1089,12:30:00 PM,2,Thursday,62,5,14,23,104,normal
1090,6:30:00 AM,7,Tuesday,139,31,44,3,217,heavy
1091,7:15:00 PM,27,Friday,33,6,0,4,43,low
1092,10:15:00 AM,17,Tuesday,90,2,15,18,125,normal
1093,8:15:00 AM,11,Wednesday,125,32,50,0,207,heavy
1094,6:30:00 PM,5,Sunday,126,40,39,8,213,heavy
1095,7:45:00 PM,26,Thursday,80,17,13,30,140,high
1096,4:00:00 PM,23,Monday,104,40,22,9,175,heavy
1097,7:00:00 AM,21,Sunday,142,27,27,4,200,heavy
1098,2:15:00 AM,25,Wednesday,10,0,0,33,43,normal
1099,10:30:00 AM,12,Thursday,59,6,11,11,87,low
1100,1:30:00 PM,11,Wednesday,6,28,27,14,75,normal
1101,9:30:00 PM,27,Friday,46,1,1,4,52,low
1102,10:15:00 PM,9,Thursday,11,4,1,30,46,normal
1103,6:15:00 PM,13,Friday,62,20,20,1,103,normal
1104,7:00:00 PM,19,Thursday,97,21,10,8,136,normal
1105,7:00:00 AM,30,Monday,140,38,38,0,216,heavy
1106,9:30:00 PM,19,Thursday,78,20,11,35,144,high
1107,6:00:00 AM,23,Monday,120,36,32,0,188,heavy
1108,2:00:00 AM,5,Sunday,12,4,1,37,54,normal
1109,7:15:00 PM,10,Tuesday,102,22,20,16,160,normal
1110,4:30:00 AM,19,Thursday,117,5,10,15,147,normal
1111,4:30:00 AM,28,Saturday,111,12,9,17,149,normal
1112,4:30:00 PM,26,Thursday,148,14,37,9,208,heavy
1113,1:30:00 PM,13,Friday,175,63,19,3,260,heavy
1114,10:30:00 AM,11,Wednesday,93,7,30,16,146,high
1115,7:15:00 AM,10,Tuesday,145,23,27,0,195,heavy
1116,8:15:00 AM,25,Wednesday,133,23,21,3,180,heavy
1117,10:45:00 PM,27,Friday,11,3,1,19,34,normal
1118,8:45:00 AM,12,Thursday,101,37,31,4,173,heavy
1119,12:30:00 PM,10,Tuesday,20,6,4,20,50,normal
1120,8:45:00 PM,28,Saturday,101,25,18,8,152,normal
1121,10:15:00 AM,6,Monday,99,16,39,26,180,heavy
1122,2:30:00 PM,24,Tuesday,52,25,15,19,111,normal
1123,8:45:00 PM,31,Tuesday,108,20,14,15,157,normal
1124,6:45:00 AM,8,Wednesday,145,11,29,1,186,heavy
1125,8:15:00 PM,3,Friday,44,6,1,3,54,low
1126,2:15:00 AM,13,Friday,15,1,0,14,30,normal
1127,5:15:00 PM,27,Friday,68,29,14,0,111,low
1128,9:45:00 AM,6,Monday,50,2,7,14,73,normal
1129,12:45:00 PM,16,Monday,39,5,3,30,77,normal
1130,12:45:00 AM,11,Wednesday,20,0,0,14,34,normal
1131,1:15:00 AM,9,Thursday,11,2,0,12,25,low
1132,2:45:00 AM,7,Tuesday,18,5,1,25,49,normal
1133,3:45:00 AM,28,Saturday,10,2,0,31,43,normal
1134,1:15:00 AM,3,Friday,17,2,0,33,52,normal
1135,2:30:00 AM,15,Sunday,11,0,0,31,42,normal
1136,6:00:00 AM,13,Friday,71,9,7,10,97,low
1137,9:30:00 AM,2,Thursday,13,25,33,12,83,normal
1138,12:45:00 AM,10,Tuesday,51,0,2,5,58,low
1139,5:00:00 AM,22,Saturday,114,28,8,16,166,normal
1140,2:00:00 AM,11,Wednesday,17,3,1,36,57,normal
1141,11:15:00 PM,25,Wednesday,17,1,1,23,42,normal
1142,3:30:00 PM,26,Thursday,33,17,22,18,90,normal
1143,6:30:00 AM,29,Sunday,116,20,40,2,178,heavy
1144,7:30:00 AM,22,Saturday,147,34,20,5,206,heavy
1145,12:00:00 AM,7,Tuesday,17,3,0,20,40,normal
1146,4:00:00 PM,2,Thursday,145,30,40,8,223,normal
1147,3:00:00 PM,17,Tuesday,120,20,21,18,179,heavy
1148,11:45:00 AM,23,Monday,52,6,13,21,92,normal
1149,9:15:00 AM,28,Saturday,29,9,21,23,82,normal
1150,7:00:00 PM,29,Sunday,61,23,18,34,136,high
1151,12:45:00 AM,9,Thursday,20,3,0,19,42,normal
1152,11:00:00 PM,26,Thursday,17,0,0,27,44,normal
1153,6:30:00 PM,15,Sunday,138,17,48,8,211,heavy
1154,8:00:00 AM,23,Monday,118,19,21,1,159,normal
1155,2:00:00 PM,23,Monday,67,20,24,12,123,normal
1156,10:00:00 PM,31,Tuesday,11,4,0,31,46,normal
1157,6:30:00 PM,11,Wednesday,144,17,33,7,201,heavy
1158,7:30:00 AM,30,Monday,149,11,42,2,204,heavy
1159,10:30:00 AM,14,Saturday,31,15,13,28,87,normal
1160,2:00:00 AM,6,Monday,14,5,0,17,36,normal
1161,9:45:00 PM,3,Friday,33,5,5,1,44,low
1162,7:00:00 AM,2,Thursday,101,20,42,4,167,normal
1163,2:30:00 PM,21,Sunday,44,11,19,15,89,normal
1164,6:00:00 AM,12,Thursday,117,38,50,5,210,heavy
1165,4:30:00 PM,7,Tuesday,121,28,21,5,175,heavy
1166,12:30:00 AM,25,Wednesday,10,1,0,26,37,normal
1167,8:15:00 AM,10,Tuesday,114,39,30,3,186,heavy
1168,5:00:00 AM,31,Tuesday,60,20,5,6,91,low
1169,7:15:00 AM,1,Wednesday,136,20,32,1,189,heavy
1170,3:30:00 PM,3,Friday,59,25,19,1,104,normal
1171,2:15:00 PM,14,Saturday,89,27,18,8,142,normal
1172,5:15:00 PM,3,Friday,56,21,4,1,82,low
1173,4:15:00 AM,13,Friday,27,6,1,11,45,low
1174,1:45:00 PM,23,Monday,42,14,15,14,85,normal
1175,9:45:00 AM,30,Monday,45,16,6,21,88,normal
1176,3:45:00 PM,19,Thursday,7,12,33,12,64,normal
1177,10:30:00 AM,28,Saturday,44,17,27,30,118,high
1178,8:30:00 AM,13,Friday,49,10,2,10,71,low
1179,3:45:00 AM,13,Friday,14,2,1,19,36,normal
1180,1:00:00 AM,14,Saturday,10,4,1,21,36,normal
1181,9:15:00 AM,27,Friday,151,55,27,2,235,heavy
1182,6:45:00 PM,21,Sunday,90,13,15,33,151,high
1183,2:30:00 PM,23,Monday,65,16,32,15,128,high
1184,11:00:00 PM,16,Monday,15,5,0,21,41,normal
1185,2:45:00 PM,21,Sunday,45,17,13,20,95,normal
1186,10:00:00 AM,11,Wednesday,17,9,18,28,72,normal
1187,9:30:00 AM,5,Sunday,99,10,11,15,135,normal
1188,9:15:00 PM,10,Tuesday,95,8,17,13,133,normal
1189,3:00:00 AM,1,Wednesday,20,5,1,34,60,normal
1190,10:30:00 AM,16,Monday,37,18,8,16,79,normal
1191,6:15:00 PM,14,Saturday,114,23,42,10,189,heavy
1192,6:15:00 AM,16,Monday,121,35,39,4,199,heavy
1193,3:45:00 AM,12,Thursday,18,4,1,30,53,normal
1194,2:30:00 PM,25,Wednesday,92,18,34,18,162,high
1195,7:45:00 PM,15,Sunday,71,23,17,14,125,normal
1196,7:00:00 AM,9,Thursday,144,14,33,4,195,heavy
1197,6:15:00 PM,30,Monday,136,32,26,8,202,heavy
1198,5:30:00 AM,19,Thursday,81,4,0,20,105,normal
1199,9:30:00 AM,10,Tuesday,15,23,30,21,89,normal
1200,8:45:00 AM,19,Thursday,128,37,50,2,217,heavy
1201,10:45:00 PM,29,Sunday,10,4,1,13,28,normal
1202,6:15:00 AM,9,Thursday,126,31,33,2,192,heavy
1203,1:45:00 PM,19,Thursday,113,17,16,20,166,normal
1204,5:45:00 PM,4,Saturday,149,33,45,10,237,heavy
1205,10:15:00 AM,23,Monday,78,1,16,30,125,high
1206,10:45:00 AM,5,Sunday,25,9,10,28,72,normal
1207,1:45:00 AM,11,Wednesday,18,4,0,11,33,low
1208,3:00:00 AM,6,Monday,10,2,0,24,36,normal
1209,7:45:00 AM,22,Saturday,128,33,21,4,186,heavy
1210,6:30:00 PM,2,Thursday,101,22,33,9,165,high
1211,8:00:00 AM,19,Thursday,133,31,27,2,193,heavy
1212,1:15:00 AM,15,Sunday,17,3,1,17,38,normal
1213,3:00:00 PM,22,Saturday,60,18,28,12,118,high
1214,10:45:00 PM,19,Thursday,15,4,1,32,52,normal
1215,10:45:00 AM,21,Sunday,68,22,25,16,131,normal
1216,4:00:00 AM,21,Sunday,10,3,0,32,45,normal
1217,1:15:00 AM,21,Sunday,20,0,0,37,57,normal
1218,12:15:00 AM,30,Monday,19,2,0,22,43,normal
1219,6:45:00 AM,15,Sunday,109,14,38,1,162,high
1220,5:15:00 PM,2,Thursday,147,28,29,10,214,heavy
1221,5:30:00 PM,17,Tuesday,113,12,22,6,153,normal
1222,5:45:00 PM,27,Friday,76,30,20,1,127,normal
1223,8:30:00 AM,20,Friday,52,19,6,10,87,low
1224,4:45:00 AM,11,Wednesday,82,23,8,20,133,normal
1225,7:00:00 AM,11,Wednesday,125,15,49,0,189,heavy
1226,6:15:00 AM,28,Saturday,128,18,31,3,180,heavy
1227,2:15:00 PM,18,Wednesday,27,26,25,15,93,normal
1228,12:15:00 AM,27,Friday,13,2,1,28,44,normal
1229,6:00:00 AM,30,Monday,112,15,24,1,152,normal
1230,3:00:00 AM,15,Sunday,16,1,0,24,41,normal
1231,6:15:00 PM,6,Monday,133,36,28,6,203,heavy
1232,11:45:00 PM,5,Sunday,18,4,0,18,40,normal
1233,6:00:00 AM,22,Saturday,150,19,24,3,196,heavy
1234,10:15:00 PM,18,Wednesday,15,1,1,29,46,normal
1235,11:15:00 AM,20,Friday,158,44,26,2,230,heavy
1236,1:30:00 AM,11,Wednesday,16,0,1,26,43,normal
1237,9:30:00 AM,15,Sunday,64,12,27,8,111,normal
1238,5:30:00 AM,27,Friday,73,17,6,13,109,normal
1239,6:15:00 AM,13,Friday,33,9,6,13,61,normal
1240,3:30:00 PM,10,Tuesday,108,16,8,18,150,normal
1241,10:00:00 AM,18,Wednesday,65,4,19,21,109,normal
1242,9:45:00 PM,14,Saturday,70,10,14,32,126,high
1243,12:30:00 AM,12,Thursday,18,5,1,13,37,normal
1244,12:45:00 AM,8,Wednesday,18,2,1,13,34,normal
1245,6:45:00 AM,29,Sunday,138,13,21,5,177,heavy
1246,10:15:00 PM,2,Thursday,16,0,1,24,41,normal
1247,5:15:00 AM,19,Thursday,109,11,4,3,127,normal
1248,11:15:00 PM,24,Tuesday,18,0,0,29,47,normal
1249,11:00:00 AM,11,Wednesday,51,10,8,22,91,normal
1250,12:45:00 PM,31,Tuesday,70,10,9,23,112,high
1251,9:45:00 AM,11,Wednesday,51,16,16,13,96,normal
1252,11:45:00 AM,31,Tuesday,34,8,14,21,77,normal
1253,9:30:00 PM,11,Wednesday,98,16,16,21,151,high
1254,7:45:00 PM,16,Monday,77,19,16,8,120,normal
1255,2:30:00 PM,20,Friday,161,56,12,4,233,heavy
1256,5:30:00 AM,11,Wednesday,91,24,7,6,128,normal
1257,8:15:00 AM,17,Tuesday,123,24,46,2,195,heavy
1258,12:15:00 AM,10,Tuesday,49,0,3,3,55,low
1259,4:00:00 PM,5,Sunday,141,15,20,6,182,heavy
1260,1:45:00 PM,22,Saturday,99,16,16,18,149,normal
1261,9:15:00 AM,6,Monday,64,13,40,12,129,high
1262,9:45:00 AM,2,Thursday,18,22,26,10,76,normal
1263,9:30:00 PM,7,Tuesday,82,7,16,9,114,normal
1264,5:00:00 PM,6,Monday,137,15,37,7,196,heavy
1265,12:45:00 AM,12,Thursday,18,2,0,37,57,normal
1266,4:30:00 PM,30,Monday,104,19,39,9,171,heavy
1267,11:30:00 PM,8,Wednesday,10,4,1,23,38,normal
1268,8:00:00 PM,20,Friday,23,4,0,5,32,low
1269,6:30:00 PM,22,Saturday,103,34,49,5,191,heavy
1270,9:15:00 PM,11,Wednesday,78,17,17,27,139,high
1271,8:30:00 AM,9,Thursday,150,20,43,0,213,heavy
1272,1:30:00 AM,28,Saturday,15,2,0,18,35,normal
1273,12:45:00 PM,12,Thursday,67,7,12,28,114,high
1274,2:30:00 PM,18,Wednesday,114,21,32,5,172,heavy
1275,4:45:00 AM,22,Saturday,102,20,9,13,144,normal
1276,3:15:00 PM,11,Wednesday,90,20,35,7,152,high
1277,11:45:00 AM,8,Wednesday,34,5,5,22,66,normal
1278,2:30:00 AM,28,Saturday,20,4,1,28,53,normal
1279,8:15:00 AM,7,Tuesday,115,39,20,2,176,heavy
1280,7:00:00 PM,20,Friday,60,21,2,1,84,low
1281,12:00:00 PM,3,Friday,148,70,15,0,233,heavy
1282,9:00:00 AM,2,Thursday,140,27,36,2,205,heavy
1283,11:30:00 PM,2,Thursday,16,2,0,35,53,normal
1284,2:15:00 AM,18,Wednesday,16,2,0,37,55,normal
1285,11:30:00 PM,20,Friday,18,5,1,11,35,low
1286,11:15:00 PM,4,Saturday,18,4,1,35,58,normal
1287,8:15:00 AM,1,Wednesday,129,37,41,1,208,heavy
1288,9:30:00 PM,24,Tuesday,88,6,18,25,137,high
1289,2:00:00 AM,22,Saturday,19,5,0,15,39,normal
1290,4:15:00 PM,7,Tuesday,143,24,35,6,208,heavy
1291,12:15:00 PM,6,Monday,44,5,3,28,80,normal
1292,1:15:00 AM,1,Wednesday,15,3,0,32,50,normal
1293,2:30:00 PM,28,Saturday,42,25,20,19,106,normal
1294,6:15:00 AM,21,Sunday,112,13,39,0,164,high
1295,12:45:00 PM,20,Friday,144,66,11,3,224,heavy
1296,9:00:00 PM,3,Friday,44,2,6,5,57,low
1297,11:45:00 AM,20,Friday,162,65,14,3,244,heavy
1298,9:15:00 AM,9,Thursday,99,17,32,7,155,high
1299,4:45:00 PM,16,Monday,129,40,31,10,210,heavy
1300,7:45:00 AM,10,Tuesday,108,18,22,1,149,normal
1301,5:15:00 AM,2,Thursday,111,22,0,12,145,normal
1302,11:45:00 PM,20,Friday,17,2,0,20,39,normal
1303,8:45:00 PM,9,Thursday,61,14,10,5,90,low
1304,11:15:00 PM,16,Monday,18,4,0,11,33,low
1305,5:00:00 AM,9,Thursday,63,29,5,15,112,normal
1306,12:45:00 PM,6,Monday,30,9,7,25,71,normal
1307,12:15:00 AM,21,Sunday,17,4,1,24,46,normal
1308,1:00:00 AM,23,Monday,12,0,1,16,29,normal
1309,10:30:00 PM,29,Sunday,12,2,0,39,53,normal
1310,10:15:00 PM,19,Thursday,18,1,0,27,46,normal
1311,11:30:00 PM,13,Friday,15,5,0,14,34,normal
1312,8:00:00 PM,3,Friday,40,10,5,10,65,low
1313,8:00:00 AM,15,Sunday,119,36,41,0,196,heavy
1314,9:15:00 PM,22,Saturday,84,21,13,9,127,normal
1315,9:45:00 PM,28,Saturday,74,16,14,34,138,high
1316,2:30:00 AM,11,Wednesday,18,2,1,25,46,normal
1317,11:15:00 AM,24,Tuesday,44,10,12,29,95,normal
1318,10:30:00 AM,13,Friday,160,47,30,3,240,heavy
1319,8:30:00 PM,28,Saturday,61,21,15,32,129,high
1320,10:15:00 AM,9,Thursday,54,1,35,26,116,high
1321,11:00:00 AM,21,Sunday,47,10,6,22,85,normal
1322,5:45:00 AM,22,Saturday,83,6,4,9,102,low
1323,2:15:00 AM,24,Tuesday,12,4,1,29,46,normal
1324,9:00:00 PM,16,Monday,73,16,14,34,137,high
1325,10:45:00 PM,2,Thursday,12,5,0,23,40,normal
1326,8:45:00 PM,24,Tuesday,56,17,20,8,101,normal
1327,12:30:00 AM,31,Tuesday,15,2,1,34,52,normal
1328,7:15:00 PM,11,Wednesday,50,10,10,17,87,normal
1329,11:00:00 PM,14,Saturday,15,0,0,16,31,normal
1330,12:45:00 PM,11,Wednesday,51,6,10,26,93,normal
1331,7:00:00 AM,22,Saturday,149,36,35,1,221,heavy
1332,2:00:00 AM,9,Thursday,17,0,0,32,49,normal
1333,3:00:00 PM,16,Monday,40,20,36,7,103,normal
1334,5:30:00 PM,29,Sunday,141,30,27,7,205,heavy
1335,3:45:00 PM,22,Saturday,53,12,25,20,110,normal
1336,4:15:00 PM,8,Wednesday,118,17,28,8,171,heavy
1337,7:45:00 PM,1,Wednesday,96,24,18,10,148,normal
1338,4:15:00 PM,15,Sunday,141,18,28,8,195,heavy
1339,2:00:00 PM,11,Wednesday,43,13,30,20,106,normal
1340,12:15:00 AM,11,Wednesday,18,0,0,29,47,normal
1341,12:45:00 AM,30,Monday,12,0,0,24,36,normal
1342,5:30:00 AM,13,Friday,63,10,6,12,91,low
1343,11:45:00 AM,13,Friday,179,46,27,3,255,heavy
1344,9:30:00 PM,26,Thursday,62,13,16,28,119,high
1345,1:45:00 PM,25,Wednesday,25,11,24,17,77,normal
1346,5:00:00 PM,23,Monday,119,29,40,10,198,heavy
1347,6:30:00 AM,31,Tuesday,137,23,27,0,187,heavy
1348,2:30:00 AM,24,Tuesday,15,5,1,16,37,normal
1349,8:15:00 PM,16,Monday,75,9,13,28,125,high
1350,5:15:00 PM,6,Monday,119,28,46,9,202,heavy
1351,5:45:00 AM,10,Tuesday,57,13,3,11,84,low
1352,5:00:00 AM,25,Wednesday,85,7,3,18,113,normal
1353,11:30:00 PM,23,Monday,14,4,1,27,46,normal
1354,12:30:00 AM,23,Monday,10,2,1,12,25,low
1355,12:45:00 AM,1,Wednesday,15,5,1,12,33,low
1356,3:30:00 PM,16,Monday,62,15,8,11,96,low
1357,2:30:00 PM,12,Thursday,33,21,25,5,84,normal
1358,10:30:00 PM,16,Monday,17,2,0,28,47,normal
1359,4:45:00 PM,3,Friday,90,21,0,0,111,low
1360,9:00:00 PM,2,Thursday,95,15,18,9,137,normal
1361,2:00:00 AM,14,Saturday,20,2,0,12,34,low
1362,12:30:00 PM,12,Thursday,59,10,14,23,106,normal
1363,8:00:00 AM,13,Friday,47,10,4,10,71,low
1364,4:45:00 PM,21,Sunday,116,35,42,6,199,heavy
1365,5:15:00 AM,7,Tuesday,59,27,10,18,114,normal
1366,4:00:00 AM,27,Friday,10,4,0,36,50,normal
1367,8:30:00 AM,28,Saturday,135,11,23,5,174,heavy
1368,5:30:00 PM,2,Thursday,146,22,50,10,228,heavy
1369,11:15:00 AM,28,Saturday,63,7,10,29,109,normal
1370,4:15:00 PM,17,Tuesday,107,28,38,9,182,heavy
1371,8:45:00 PM,16,Monday,77,17,17,22,133,high
1372,6:00:00 AM,15,Sunday,111,18,41,2,172,heavy
1373,7:00:00 PM,1,Wednesday,87,6,18,30,141,high
1374,4:45:00 AM,2,Thursday,116,20,5,14,155,normal
1375,5:45:00 AM,27,Friday,77,20,4,13,114,normal
1376,4:30:00 PM,3,Friday,59,25,8,0,92,low
1377,9:30:00 AM,24,Tuesday,41,12,15,10,78,low
1378,7:00:00 PM,10,Tuesday,90,12,10,13,125,normal
1379,10:15:00 PM,7,Tuesday,11,3,1,39,54,normal
1380,4:45:00 PM,12,Thursday,113,13,42,10,178,heavy
1381,5:30:00 PM,16,Monday,127,32,29,7,195,heavy
1382,7:00:00 PM,8,Wednesday,59,13,18,27,117,high
1383,5:00:00 PM,22,Saturday,110,30,46,5,191,heavy
1384,1:45:00 AM,23,Monday,17,3,0,10,30,low
1385,10:00:00 AM,27,Friday,167,60,27,3,257,heavy
1386,10:30:00 PM,18,Wednesday,14,1,1,25,41,normal
1387,10:15:00 PM,20,Friday,16,5,0,26,47,normal
1388,9:45:00 AM,23,Monday,66,2,10,28,106,normal
1389,3:45:00 PM,29,Sunday,68,28,31,15,142,high
1390,5:00:00 PM,17,Tuesday,147,28,23,5,203,heavy
1391,4:15:00 PM,18,Wednesday,138,39,31,7,215,heavy
1392,11:30:00 AM,27,Friday,154,61,16,3,234,heavy
1393,11:15:00 AM,26,Thursday,52,10,9,23,94,normal
1394,7:45:00 AM,4,Saturday,137,13,31,5,186,heavy
1395,1:15:00 AM,31,Tuesday,20,0,1,20,41,normal
1396,8:45:00 AM,29,Sunday,149,20,30,5,204,heavy
1397,10:30:00 PM,24,Tuesday,16,1,0,29,46,normal
1398,9:30:00 AM,21,Sunday,12,25,39,28,104,normal
1399,7:15:00 AM,11,Wednesday,125,32,50,5,212,heavy
1400,3:30:00 AM,19,Thursday,17,4,1,20,42,normal
1401,7:30:00 PM,7,Tuesday,58,23,14,34,129,high
1402,12:30:00 AM,3,Friday,17,1,0,32,50,normal
1403,10:15:00 PM,16,Monday,12,1,0,11,24,low
1404,1:30:00 AM,21,Sunday,18,0,1,30,49,normal
1405,8:45:00 AM,21,Sunday,139,36,40,3,218,heavy
1406,7:45:00 PM,18,Wednesday,97,25,19,24,165,high
1407,7:30:00 AM,31,Tuesday,108,35,22,3,168,heavy
1408,2:45:00 AM,11,Wednesday,12,2,0,19,33,normal
1409,5:00:00 AM,30,Monday,94,1,1,14,110,normal
1410,12:15:00 PM,14,Saturday,39,10,4,29,82,normal
1411,7:30:00 AM,2,Thursday,141,39,40,5,225,heavy
1412,9:00:00 PM,5,Sunday,109,6,15,18,148,normal
1413,4:45:00 AM,3,Friday,76,9,7,13,105,normal
1414,4:45:00 AM,15,Sunday,86,24,3,18,131,normal
1415,3:15:00 AM,18,Wednesday,14,5,0,17,36,normal
1416,2:30:00 AM,2,Thursday,16,2,0,35,53,normal
1417,8:00:00 PM,30,Monday,68,6,15,34,123,high
1418,1:15:00 AM,5,Sunday,19,1,0,11,31,low
1419,12:15:00 AM,6,Monday,13,1,0,24,38,normal
1420,10:45:00 PM,7,Tuesday,12,0,1,32,45,normal
1421,4:45:00 PM,24,Tuesday,103,17,28,5,153,high
1422,3:45:00 PM,27,Friday,51,27,25,2,105,normal
1423,10:15:00 AM,10,Tuesday,27,16,36,30,109,normal
1424,3:00:00 AM,26,Thursday,17,5,1,19,42,normal
1425,6:15:00 AM,30,Monday,148,26,25,0,199,heavy
1426,8:15:00 AM,28,Saturday,109,28,39,2,178,heavy
1427,10:15:00 PM,30,Monday,15,1,0,34,50,normal
1428,8:15:00 AM,4,Saturday,105,14,35,2,156,high
1429,11:45:00 PM,10,Tuesday,17,2,0,22,41,normal
1430,10:30:00 PM,28,Saturday,14,3,0,20,37,normal
1431,4:00:00 PM,28,Saturday,101,37,48,9,195,heavy
1432,8:45:00 AM,4,Saturday,116,22,30,3,171,heavy
1433,6:30:00 PM,7,Tuesday,120,15,34,8,177,heavy
1434,8:00:00 AM,22,Saturday,111,38,50,5,204,heavy
1435,9:15:00 PM,14,Saturday,82,5,12,34,133,high
1436,12:30:00 PM,14,Saturday,38,9,8,22,77,normal
1437,4:00:00 PM,18,Wednesday,110,15,46,5,176,heavy
1438,6:15:00 PM,28,Saturday,115,23,22,7,167,normal
1439,11:30:00 AM,3,Friday,140,67,20,4,231,heavy
1440,9:30:00 AM,7,Tuesday,28,7,25,18,78,normal
1441,6:45:00 AM,25,Wednesday,150,17,28,0,195,heavy
1442,11:15:00 AM,14,Saturday,59,7,13,21,100,normal
1443,8:00:00 PM,18,Wednesday,98,8,10,19,135,normal
1444,8:15:00 PM,18,Wednesday,94,13,19,25,151,high
1445,9:15:00 PM,9,Thursday,91,5,12,34,142,high
1446,1:00:00 PM,22,Saturday,43,9,3,25,80,normal
1447,3:15:00 AM,2,Thursday,14,5,0,19,38,normal
1448,2:15:00 AM,31,Tuesday,19,1,1,28,49,normal
1449,7:00:00 AM,25,Wednesday,136,29,23,0,188,heavy
1450,9:15:00 AM,17,Tuesday,66,16,22,13,117,normal
1451,7:45:00 PM,27,Friday,22,7,1,2,32,low
1452,7:30:00 AM,28,Saturday,143,28,27,4,202,heavy
1453,10:15:00 AM,21,Sunday,81,10,39,29,159,high
1454,6:00:00 AM,31,Tuesday,129,31,36,1,197,heavy
1455,10:45:00 AM,8,Wednesday,84,9,31,17,141,high
1456,7:15:00 AM,5,Sunday,105,17,29,4,155,high
1457,5:45:00 PM,13,Friday,67,28,25,0,120,normal
1458,1:45:00 PM,16,Monday,70,22,38,7,137,high
1459,4:45:00 AM,8,Wednesday,103,26,6,12,147,normal
1460,8:15:00 PM,17,Tuesday,93,6,15,17,131,normal
1461,12:30:00 AM,19,Thursday,10,3,1,32,46,normal
1462,6:30:00 PM,18,Wednesday,101,13,47,10,171,heavy
1463,9:15:00 AM,26,Thursday,45,4,30,29,108,normal
1464,3:45:00 PM,13,Friday,82,23,14,0,119,normal
1465,12:30:00 AM,16,Monday,16,3,0,34,53,normal
1466,4:30:00 PM,9,Thursday,107,14,44,5,170,heavy
1467,3:15:00 AM,15,Sunday,18,3,0,28,49,normal
1468,3:45:00 PM,16,Monday,81,20,14,12,127,normal
1469,6:00:00 PM,23,Monday,110,12,47,8,177,heavy
1470,3:45:00 PM,26,Thursday,14,21,23,6,64,normal
1471,9:15:00 PM,7,Tuesday,86,12,17,18,133,normal
1472,10:45:00 AM,24,Tuesday,69,17,5,28,119,high
1473,8:00:00 AM,29,Sunday,140,31,21,4,196,heavy
1474,3:30:00 AM,31,Tuesday,10,1,0,39,50,normal
1475,10:45:00 PM,31,Tuesday,14,2,0,40,56,normal
1476,4:30:00 AM,3,Friday,39,20,1,10,70,low
1477,12:00:00 PM,15,Sunday,62,10,11,22,105,normal
1478,4:30:00 AM,21,Sunday,104,22,7,11,144,normal
1479,11:00:00 AM,13,Friday,169,70,20,3,262,heavy
1480,12:15:00 AM,22,Saturday,14,3,0,23,40,normal
1481,3:15:00 PM,1,Wednesday,73,29,23,7,132,normal
1482,2:45:00 AM,21,Sunday,12,2,1,10,25,low
1483,11:30:00 PM,9,Thursday,16,5,0,27,48,normal
1484,1:15:00 PM,17,Tuesday,7,16,11,14,48,normal
1485,5:45:00 AM,16,Monday,96,9,1,16,122,normal
1486,2:15:00 AM,1,Wednesday,10,4,0,19,33,normal
1487,1:30:00 PM,23,Monday,103,10,23,7,143,normal
1488,12:45:00 PM,5,Sunday,21,8,4,28,61,normal
1489,1:00:00 PM,18,Wednesday,49,5,11,21,86,normal
1490,9:30:00 PM,1,Wednesday,98,9,15,18,140,normal
1491,8:15:00 PM,7,Tuesday,69,8,13,28,118,high
1492,3:30:00 PM,6,Monday,6,11,34,20,71,normal
1493,4:15:00 PM,11,Wednesday,113,14,20,5,152,normal
1494,11:30:00 AM,18,Wednesday,21,10,6,30,67,normal
1495,9:15:00 PM,23,Monday,65,24,14,19,122,normal
1496,7:15:00 AM,28,Saturday,116,22,37,2,177,heavy
1497,7:00:00 AM,13,Friday,57,14,3,11,85,low
1498,7:30:00 PM,3,Friday,36,6,7,2,51,low
1499,10:15:00 PM,14,Saturday,14,1,1,40,56,normal
1500,5:00:00 AM,12,Thursday,85,22,9,9,125,normal
1501,1:00:00 PM,7,Tuesday,36,5,6,20,67,normal
1502,1:30:00 AM,25,Wednesday,19,1,1,11,32,low
1503,7:30:00 AM,17,Tuesday,130,10,37,1,178,heavy
1504,11:30:00 PM,16,Monday,12,4,0,21,37,normal
1505,7:30:00 AM,19,Thursday,132,33,35,2,202,heavy
1506,10:45:00 AM,22,Saturday,37,19,38,12,106,normal
1507,10:00:00 AM,12,Thursday,26,2,39,26,93,normal
1508,12:30:00 PM,30,Monday,46,9,11,23,89,normal
1509,9:30:00 PM,23,Monday,94,10,11,22,137,high
1510,7:45:00 AM,20,Friday,54,11,4,12,81,low
1511,11:45:00 AM,18,Wednesday,48,8,11,22,89,normal
1512,12:30:00 AM,1,Wednesday,19,1,1,18,39,normal
1513,6:30:00 PM,3,Friday,63,30,21,0,114,normal
1514,10:45:00 AM,29,Sunday,54,24,37,20,135,high
1515,1:00:00 PM,6,Monday,68,7,5,25,105,normal
1516,1:45:00 AM,17,Tuesday,15,3,0,19,37,normal
1517,5:00:00 PM,24,Tuesday,136,38,20,5,199,heavy
1518,3:30:00 PM,21,Sunday,77,23,13,9,122,normal
1519,3:45:00 AM,27,Friday,20,1,0,23,44,normal
1520,9:00:00 PM,26,Thursday,98,18,20,22,158,high
1521,3:00:00 PM,23,Monday,11,18,22,10,61,normal
1522,5:45:00 AM,29,Sunday,108,24,2,19,153,normal
1523,2:00:00 PM,24,Tuesday,75,23,31,13,142,high
1524,6:45:00 AM,22,Saturday,140,21,39,3,203,heavy
1525,1:30:00 AM,6,Monday,15,2,1,16,34,normal
1526,8:30:00 AM,1,Wednesday,127,18,28,3,176,heavy
1527,9:15:00 AM,12,Thursday,24,18,37,18,97,normal
1528,9:45:00 AM,3,Friday,168,68,27,2,265,heavy
1529,10:30:00 PM,6,Monday,13,5,1,23,42,normal
1530,3:30:00 AM,7,Tuesday,18,2,1,27,48,normal
1531,1:00:00 PM,17,Tuesday,28,6,3,27,64,normal
1532,1:45:00 PM,5,Sunday,120,21,22,14,177,heavy
1533,3:30:00 PM,20,Friday,60,27,17,2,106,normal
1534,11:00:00 PM,4,Saturday,19,2,0,36,57,normal
1535,5:15:00 PM,10,Tuesday,122,37,23,8,190,heavy
1536,10:45:00 AM,9,Thursday,99,18,39,19,175,heavy
1537,12:30:00 PM,20,Friday,173,63,13,2,251,heavy
1538,6:45:00 AM,7,Tuesday,129,14,43,5,191,heavy
1539,5:45:00 AM,18,Wednesday,50,4,6,13,73,normal
1540,11:30:00 PM,25,Wednesday,17,2,0,23,42,normal
1541,5:45:00 AM,15,Sunday,111,6,2,5,124,normal
1542,12:45:00 PM,15,Sunday,20,10,12,24,66,normal
1543,2:00:00 AM,12,Thursday,18,1,1,34,54,normal
1544,8:00:00 AM,26,Thursday,135,23,48,0,206,heavy
1545,5:45:00 AM,9,Thursday,90,21,2,14,127,normal
1546,7:30:00 PM,20,Friday,39,5,4,11,59,low
1547,5:45:00 PM,12,Thursday,109,16,41,9,175,heavy
1548,12:30:00 PM,16,Monday,69,5,13,27,114,high
1549,7:45:00 AM,14,Saturday,124,34,24,4,186,heavy
1550,5:00:00 AM,29,Sunday,82,2,4,14,102,normal
1551,10:00:00 PM,16,Monday,15,5,1,32,53,normal
1552,11:30:00 AM,1,Wednesday,42,6,10,21,79,normal
1553,4:15:00 PM,9,Thursday,116,24,36,6,182,heavy
1554,4:15:00 AM,7,Tuesday,116,0,1,9,126,normal
1555,5:00:00 PM,8,Wednesday,120,35,43,7,205,heavy
1556,1:00:00 AM,1,Wednesday,13,2,1,26,42,normal
1557,4:45:00 PM,20,Friday,50,26,9,1,86,low
1558,5:30:00 PM,5,Sunday,140,35,41,5,221,heavy
1559,8:00:00 AM,28,Saturday,121,35,32,0,188,heavy
1560,3:15:00 PM,4,Saturday,120,30,28,15,193,heavy
1561,7:00:00 AM,29,Sunday,132,25,40,2,199,heavy
1562,3:15:00 PM,23,Monday,28,15,27,12,82,normal
1563,3:00:00 PM,2,Thursday,24,20,15,17,76,normal
1564,4:00:00 AM,30,Monday,20,4,0,34,58,normal
1565,8:15:00 PM,26,Thursday,90,19,15,13,137,normal
1566,12:15:00 PM,26,Thursday,70,10,3,30,113,high
1567,8:30:00 PM,12,Thursday,50,7,11,23,91,normal
1568,2:15:00 PM,6,Monday,49,21,11,20,101,normal
1569,4:45:00 PM,26,Thursday,122,16,28,6,172,heavy
1570,5:30:00 PM,7,Tuesday,145,39,23,6,213,heavy
1571,2:00:00 AM,8,Wednesday,15,1,0,21,37,normal
1572,12:30:00 AM,10,Tuesday,46,0,3,6,55,low
1573,2:00:00 PM,22,Saturday,20,27,32,12,91,normal
1574,1:30:00 PM,5,Sunday,90,30,32,8,160,high
1575,10:45:00 PM,20,Friday,14,5,0,11,30,low
1576,4:45:00 PM,4,Saturday,133,17,22,8,180,heavy
1577,2:15:00 PM,28,Saturday,67,12,10,20,109,normal
1578,2:45:00 PM,30,Monday,62,29,31,11,133,high
1579,4:45:00 PM,1,Wednesday,134,15,29,8,186,heavy
1580,9:30:00 AM,30,Monday,38,8,6,5,57,low
1581,4:30:00 AM,16,Monday,91,8,6,2,107,low
1582,8:15:00 AM,30,Monday,138,39,45,4,226,heavy
1583,8:00:00 AM,25,Wednesday,131,19,26,1,177,heavy
1584,11:30:00 PM,31,Tuesday,14,5,0,13,32,normal
1585,2:45:00 PM,31,Tuesday,50,24,30,5,109,normal
1586,1:30:00 PM,9,Thursday,95,28,22,9,154,normal
1587,1:30:00 AM,24,Tuesday,15,0,1,26,42,normal
1588,7:00:00 PM,4,Saturday,91,17,18,29,155,high
1589,4:15:00 PM,3,Friday,50,24,11,0,85,low
1590,11:00:00 PM,19,Thursday,13,4,0,32,49,normal
1591,4:00:00 AM,25,Wednesday,20,3,1,35,59,normal
1592,9:00:00 AM,4,Saturday,143,28,46,1,218,heavy
1593,11:00:00 PM,21,Sunday,20,4,1,26,51,normal
1594,4:15:00 PM,12,Thursday,135,37,34,5,211,heavy
1595,8:15:00 AM,22,Saturday,144,20,32,4,200,heavy
1596,9:00:00 PM,4,Saturday,61,10,16,27,114,high
1597,7:00:00 PM,22,Saturday,54,17,17,19,107,normal
1598,7:30:00 PM,28,Saturday,105,23,15,18,161,normal
1599,2:30:00 AM,22,Saturday,14,5,0,10,29,low
1600,8:30:00 PM,4,Saturday,106,12,16,9,143,normal
1601,7:15:00 AM,26,Thursday,101,35,42,3,181,heavy
1602,12:00:00 AM,27,Friday,16,3,0,28,47,normal
1603,6:45:00 PM,18,Wednesday,105,17,13,23,158,high
1604,7:00:00 AM,31,Tuesday,134,10,44,0,188,heavy
1605,10:30:00 PM,13,Friday,12,0,1,17,30,normal
1606,6:15:00 AM,24,Tuesday,124,25,31,1,181,heavy
1607,10:00:00 PM,10,Tuesday,13,1,0,19,33,normal
1608,11:00:00 AM,23,Monday,57,9,5,23,94,normal
1609,8:30:00 AM,27,Friday,31,15,4,12,62,low
1610,9:45:00 AM,24,Tuesday,41,9,7,27,84,normal
1611,9:45:00 PM,27,Friday,26,3,2,3,34,low
1612,2:00:00 PM,21,Sunday,45,16,15,5,81,low
1613,7:00:00 AM,28,Saturday,108,13,38,1,160,high
1614,9:15:00 PM,31,Tuesday,64,14,10,6,94,low
1615,1:30:00 PM,26,Thursday,82,30,32,10,154,high
1616,1:15:00 PM,8,Wednesday,19,21,25,15,80,normal
1617,11:30:00 AM,22,Saturday,67,5,7,22,101,normal
1618,4:00:00 PM,31,Tuesday,126,24,35,8,193,heavy
1619,7:00:00 AM,8,Wednesday,112,33,29,3,177,heavy
1620,9:30:00 AM,20,Friday,170,62,18,2,252,heavy
1621,1:00:00 AM,11,Wednesday,20,1,1,30,52,normal
1622,2:45:00 AM,17,Tuesday,20,4,1,23,48,normal
1623,9:30:00 AM,13,Friday,131,52,15,0,198,heavy
1624,1:30:00 AM,12,Thursday,18,5,1,12,36,low
1625,9:15:00 PM,21,Sunday,87,16,10,16,129,normal
1626,10:45:00 PM,4,Saturday,18,1,0,18,37,normal
1627,12:30:00 AM,24,Tuesday,20,4,0,32,56,normal
1628,2:00:00 PM,19,Thursday,52,13,15,10,90,low
1629,1:15:00 PM,29,Sunday,47,26,6,20,99,normal
1630,3:30:00 AM,9,Thursday,15,0,1,24,40,normal
1631,12:15:00 PM,18,Wednesday,69,5,13,22,109,normal
1632,9:45:00 AM,1,Wednesday,79,8,16,12,115,normal
1633,3:45:00 AM,18,Wednesday,19,0,0,18,37,normal
1634,7:00:00 AM,26,Thursday,146,17,34,0,197,heavy
1635,6:45:00 PM,11,Wednesday,103,21,11,11,146,normal
1636,12:00:00 AM,8,Wednesday,17,2,1,20,40,normal
1637,1:45:00 AM,16,Monday,19,4,0,17,40,normal
1638,12:00:00 AM,23,Monday,13,2,1,17,33,normal
1639,5:15:00 PM,30,Monday,124,23,46,5,198,heavy
1640,5:45:00 AM,1,Wednesday,84,16,10,5,115,normal
1641,7:00:00 AM,3,Friday,27,10,2,12,51,low
1642,11:45:00 PM,19,Thursday,14,0,1,21,36,normal
1643,9:45:00 AM,28,Saturday,42,9,37,28,116,high
1644,1:15:00 PM,11,Wednesday,104,17,25,20,166,normal
1645,9:15:00 AM,11,Wednesday,39,10,37,16,102,normal
1646,9:30:00 PM,20,Friday,26,3,5,3,37,low
1647,3:00:00 PM,7,Tuesday,114,11,39,13,177,heavy
1648,1:15:00 AM,7,Tuesday,17,3,0,36,56,normal
1649,10:30:00 AM,27,Friday,180,62,26,4,272,heavy
1650,6:45:00 AM,5,Sunday,114,30,21,2,167,normal
1651,2:00:00 AM,28,Saturday,11,2,0,18,31,normal
1652,5:45:00 AM,26,Thursday,73,11,4,3,91,low
1653,10:00:00 AM,17,Tuesday,78,22,16,25,141,high
1654,12:15:00 AM,29,Sunday,14,2,1,26,43,normal
1655,9:00:00 PM,25,Wednesday,76,9,17,14,116,normal
1656,3:00:00 AM,19,Thursday,12,3,1,13,29,normal
1657,9:30:00 PM,31,Tuesday,71,14,17,10,112,normal
1658,6:45:00 PM,14,Saturday,93,24,17,23,157,high
1659,5:30:00 PM,18,Wednesday,134,39,21,9,203,heavy
1660,10:00:00 PM,22,Saturday,12,5,0,27,44,normal
1661,4:45:00 PM,30,Monday,147,21,40,9,217,heavy
1662,9:15:00 PM,27,Friday,47,6,2,12,67,low
1663,5:45:00 PM,1,Wednesday,129,13,43,6,191,heavy
1664,10:45:00 PM,12,Thursday,15,0,1,20,36,normal
1665,8:30:00 PM,19,Thursday,105,19,10,25,159,high
1666,5:30:00 AM,4,Saturday,106,19,10,17,152,normal
1667,8:30:00 AM,31,Tuesday,110,40,50,2,202,heavy
1668,6:45:00 AM,23,Monday,135,13,20,3,171,heavy
1669,6:00:00 AM,16,Monday,134,15,42,5,196,heavy
1670,6:00:00 PM,21,Sunday,112,34,39,9,194,heavy
1671,9:00:00 PM,24,Tuesday,102,18,19,29,168,heavy
1672,9:45:00 PM,24,Tuesday,104,15,10,32,161,high
1673,8:15:00 AM,19,Thursday,140,20,44,4,208,heavy
1674,3:00:00 AM,4,Saturday,17,0,1,30,48,normal
1675,7:00:00 AM,15,Sunday,105,16,22,3,146,normal
1676,6:15:00 AM,23,Monday,135,20,31,0,186,heavy
1677,1:45:00 PM,13,Friday,172,62,20,2,256,heavy
1678,4:15:00 AM,28,Saturday,97,22,4,18,141,normal
1679,8:45:00 PM,14,Saturday,99,13,20,30,162,high
1680,6:45:00 PM,7,Tuesday,56,19,16,13,104,normal
1681,4:45:00 PM,6,Monday,135,29,39,7,210,heavy
1682,1:30:00 PM,18,Wednesday,96,23,31,14,164,high
1683,6:15:00 AM,19,Thursday,103,11,35,5,154,high
1684,8:00:00 AM,21,Sunday,102,16,43,4,165,high
1685,4:45:00 PM,22,Saturday,150,29,27,7,213,heavy
1686,10:15:00 AM,7,Tuesday,22,7,39,23,91,normal
1687,6:30:00 PM,23,Monday,132,29,25,7,193,heavy
1688,4:15:00 PM,20,Friday,78,22,12,1,113,normal
1689,8:30:00 PM,15,Sunday,59,23,10,35,127,high
1690,4:15:00 AM,5,Sunday,93,4,1,16,114,normal
1691,8:00:00 AM,20,Friday,54,18,3,12,87,low
1692,12:45:00 AM,19,Thursday,14,2,0,15,31,normal
1693,7:30:00 AM,18,Wednesday,141,24,47,4,216,heavy
1694,9:00:00 PM,27,Friday,24,11,6,2,43,low
1695,8:00:00 PM,27,Friday,31,6,0,15,52,normal
1696,11:15:00 PM,12,Thursday,13,1,0,29,43,normal
1697,3:15:00 PM,22,Saturday,81,26,13,17,137,normal
1698,8:30:00 AM,11,Wednesday,125,31,45,0,201,heavy
1699,5:45:00 PM,15,Sunday,121,39,47,8,215,heavy
1700,10:30:00 AM,18,Wednesday,37,3,32,18,90,normal
1701,12:15:00 AM,24,Tuesday,18,4,1,39,62,normal
1702,4:30:00 AM,5,Sunday,114,12,7,18,151,normal
1703,4:00:00 AM,20,Friday,13,0,0,38,51,normal
1704,5:15:00 PM,29,Sunday,104,31,41,9,185,heavy
1705,3:45:00 AM,30,Monday,15,3,1,26,45,normal
1706,3:30:00 PM,14,Saturday,19,14,24,6,63,normal
1707,3:45:00 AM,26,Thursday,11,4,1,38,54,normal
1708,5:30:00 PM,10,Tuesday,136,30,20,9,195,heavy
1709,12:15:00 PM,1,Wednesday,64,10,4,28,106,normal
1710,11:00:00 PM,9,Thursday,11,0,1,30,42,normal
1711,2:45:00 PM,3,Friday,139,43,27,3,212,heavy
1712,2:00:00 AM,4,Saturday,14,0,1,12,27,low
1713,4:00:00 AM,22,Saturday,13,4,0,17,34,normal
1714,2:15:00 AM,6,Monday,11,3,1,10,25,low
1715,8:15:00 PM,9,Thursday,91,13,18,13,135,normal
1716,8:30:00 AM,21,Sunday,117,19,42,3,181,heavy
1717,10:30:00 AM,19,Thursday,29,15,25,5,74,normal
1718,1:15:00 AM,23,Monday,11,5,1,31,48,normal
1719,6:45:00 PM,4,Saturday,97,13,11,15,136,normal
1720,8:15:00 AM,16,Monday,102,17,33,0,152,high
1721,2:30:00 AM,21,Sunday,20,3,0,24,47,normal
1722,3:15:00 AM,16,Monday,16,2,1,27,46,normal
1723,4:15:00 AM,16,Monday,61,4,5,17,87,normal
1724,10:15:00 PM,10,Tuesday,10,0,1,24,35,normal
1725,1:45:00 PM,3,Friday,142,55,21,1,219,heavy
1726,3:15:00 PM,29,Sunday,95,22,28,9,154,high
1727,5:45:00 PM,5,Sunday,103,24,28,8,163,high
1728,2:15:00 AM,10,Tuesday,34,0,4,7,45,low
1729,10:15:00 PM,23,Monday,17,1,1,36,55,normal
1730,6:00:00 AM,24,Tuesday,109,40,38,0,187,heavy
1731,3:30:00 PM,7,Tuesday,39,12,21,9,81,normal
1732,1:00:00 AM,27,Friday,12,3,0,26,41,normal
1733,11:15:00 PM,7,Tuesday,15,4,0,26,45,normal
1734,1:00:00 AM,4,Saturday,15,5,0,10,30,low
1735,7:45:00 AM,28,Saturday,118,32,21,5,176,heavy
1736,3:30:00 PM,4,Saturday,38,27,12,18,95,normal
1737,1:15:00 PM,24,Tuesday,45,17,24,11,97,normal
1738,2:00:00 PM,8,Wednesday,93,10,9,15,127,normal
1739,6:00:00 PM,20,Friday,89,26,0,2,117,normal
1740,10:45:00 PM,23,Monday,11,1,0,19,31,normal
1741,11:45:00 PM,29,Sunday,16,1,0,12,29,low
1742,12:30:00 AM,13,Friday,19,3,0,16,38,normal
1743,8:00:00 PM,17,Tuesday,61,23,13,18,115,normal
1744,12:45:00 AM,20,Friday,13,4,1,14,32,normal
1745,2:15:00 AM,8,Wednesday,11,3,1,34,49,normal
1746,10:45:00 AM,10,Tuesday,41,23,20,17,101,normal
1747,12:45:00 PM,22,Saturday,41,5,4,25,75,normal
1748,7:15:00 PM,18,Wednesday,51,23,15,13,102,normal
1749,8:15:00 AM,15,Sunday,108,35,39,0,182,heavy
1750,5:45:00 AM,23,Monday,117,10,10,18,155,normal
1751,1:30:00 PM,6,Monday,96,20,14,18,148,normal
1752,1:30:00 PM,22,Saturday,101,28,18,20,167,normal
1753,1:45:00 PM,11,Wednesday,54,29,37,9,129,high
1754,6:30:00 PM,10,Tuesday,105,15,21,9,150,normal
1755,10:00:00 PM,1,Wednesday,17,4,0,36,57,normal
1756,9:45:00 PM,7,Tuesday,102,5,19,11,137,normal
1757,2:30:00 PM,10,Tuesday,110,17,23,20,170,heavy
1758,12:00:00 PM,29,Sunday,55,7,8,27,97,normal
1759,7:30:00 AM,27,Friday,30,9,7,10,56,low
1760,5:15:00 PM,23,Monday,119,25,32,9,185,heavy
1761,6:45:00 AM,21,Sunday,123,14,26,3,166,high
1762,4:45:00 PM,15,Sunday,105,38,23,5,171,heavy
1763,5:15:00 PM,5,Sunday,138,15,31,10,194,heavy
1764,3:30:00 AM,22,Saturday,19,2,1,23,45,normal
1765,6:30:00 PM,8,Wednesday,121,21,49,8,199,heavy
1766,1:00:00 AM,31,Tuesday,12,0,0,33,45,normal
1767,7:45:00 PM,29,Sunday,75,20,19,19,133,normal
1768,6:00:00 PM,25,Wednesday,100,16,37,7,160,high
1769,9:45:00 AM,19,Thursday,99,14,33,14,160,high
1770,8:45:00 AM,25,Wednesday,124,21,35,2,182,heavy
1771,3:30:00 PM,12,Thursday,10,19,26,8,63,normal
1772,2:00:00 AM,3,Friday,11,5,1,11,28,low
1773,12:30:00 AM,22,Saturday,11,5,1,11,28,low
1774,11:45:00 PM,11,Wednesday,18,4,1,40,63,normal
1775,5:30:00 PM,25,Wednesday,137,23,28,7,195,heavy
1776,10:15:00 AM,11,Wednesday,48,25,36,21,130,high
1777,11:45:00 PM,17,Tuesday,20,1,1,38,60,normal
1778,4:30:00 AM,15,Sunday,72,26,6,4,108,low
1779,3:00:00 AM,20,Friday,12,3,0,40,55,normal
1780,9:00:00 PM,23,Monday,73,18,10,35,136,high
1781,4:15:00 PM,5,Sunday,150,19,46,7,222,heavy
1782,9:30:00 AM,9,Thursday,22,15,7,19,63,normal
1783,7:30:00 AM,5,Sunday,124,29,41,1,195,heavy
1784,8:15:00 AM,12,Thursday,104,24,40,0,168,heavy
1785,3:45:00 PM,12,Thursday,46,22,18,9,95,normal
1786,3:30:00 PM,9,Thursday,86,21,31,18,156,high
1787,9:30:00 PM,18,Wednesday,84,23,19,15,141,normal
1788,11:15:00 PM,11,Wednesday,18,0,1,12,31,low
1789,8:15:00 PM,12,Thursday,103,14,12,5,134,normal
1790,8:45:00 AM,31,Tuesday,123,12,22,3,160,normal
1791,4:15:00 AM,23,Monday,96,18,7,2,123,normal
1792,6:15:00 PM,4,Saturday,106,11,45,9,171,heavy
1793,9:00:00 PM,31,Tuesday,69,13,13,8,103,low
1794,4:00:00 PM,10,Tuesday,141,31,36,6,214,heavy
1795,3:30:00 PM,8,Wednesday,34,23,19,17,93,normal
1796,10:00:00 AM,16,Monday,18,15,9,15,57,normal
1797,11:15:00 AM,3,Friday,180,48,17,2,247,heavy
1798,12:30:00 PM,6,Monday,33,6,14,28,81,normal
1799,2:00:00 AM,20,Friday,20,4,1,21,46,normal
1800,11:30:00 PM,3,Friday,18,4,1,11,34,low
1801,2:15:00 AM,7,Tuesday,14,5,0,39,58,normal
1802,8:00:00 PM,29,Sunday,58,17,20,22,117,high
1803,11:15:00 PM,21,Sunday,14,4,0,10,28,low
1804,8:45:00 AM,3,Friday,55,17,7,15,94,normal
1805,3:45:00 AM,24,Tuesday,20,4,1,33,58,normal
1806,9:45:00 PM,9,Thursday,107,14,10,18,149,normal
1807,2:30:00 PM,19,Thursday,44,19,22,6,91,normal
1808,8:45:00 PM,17,Tuesday,86,6,12,9,113,normal
1809,5:30:00 PM,8,Wednesday,106,22,43,5,176,heavy
1810,4:00:00 PM,13,Friday,77,20,7,0,104,low
1811,2:45:00 PM,1,Wednesday,89,19,37,18,163,high
1812,5:15:00 AM,13,Friday,57,11,7,10,85,low
1813,8:00:00 PM,25,Wednesday,87,21,14,34,156,high
1814,11:15:00 AM,27,Friday,174,53,10,3,240,heavy
1815,3:45:00 PM,4,Saturday,94,17,14,15,140,normal
1816,10:45:00 AM,14,Saturday,12,22,8,11,53,low
1817,10:45:00 PM,25,Wednesday,11,1,0,35,47,normal
1818,4:15:00 PM,13,Friday,66,24,1,0,91,low
1819,4:00:00 PM,4,Saturday,107,28,45,8,188,heavy
1820,6:15:00 PM,16,Monday,114,40,31,5,190,heavy
1821,8:00:00 PM,15,Sunday,58,5,19,25,107,normal
1822,2:00:00 AM,31,Tuesday,10,0,1,38,49,normal
1823,7:45:00 AM,15,Sunday,114,24,46,2,186,heavy
1824,10:30:00 PM,12,Thursday,15,0,0,32,47,normal
1825,9:00:00 AM,17,Tuesday,132,18,32,2,184,heavy
1826,3:15:00 AM,11,Wednesday,19,1,1,36,57,normal
1827,6:00:00 PM,1,Wednesday,127,35,23,10,195,heavy
1828,3:30:00 AM,8,Wednesday,11,0,1,33,45,normal
1829,7:15:00 AM,3,Friday,61,20,7,14,102,normal
1830,7:30:00 AM,21,Sunday,134,24,21,2,181,heavy
1831,9:15:00 PM,24,Tuesday,60,23,10,13,106,normal
1832,1:45:00 PM,14,Saturday,60,14,28,9,111,normal
1833,9:45:00 AM,4,Saturday,67,5,36,17,125,high
1834,1:30:00 PM,17,Tuesday,8,12,22,8,50,normal
1835,10:30:00 PM,1,Wednesday,15,2,0,10,27,low
1836,10:15:00 PM,22,Saturday,19,1,1,38,59,normal
1837,1:15:00 PM,31,Tuesday,6,24,12,13,55,normal
1838,11:45:00 AM,24,Tuesday,65,7,10,21,103,normal
1839,2:45:00 AM,27,Friday,16,5,1,29,51,normal
1840,4:30:00 PM,19,Thursday,100,38,36,9,183,heavy
1841,3:30:00 PM,5,Sunday,70,18,28,5,121,high
1842,12:00:00 PM,24,Tuesday,29,5,12,21,67,normal
1843,1:30:00 PM,2,Thursday,116,21,22,17,176,heavy
1844,8:45:00 AM,23,Monday,120,26,22,1,169,heavy
1845,7:45:00 PM,22,Saturday,69,23,12,31,135,high
1846,1:45:00 AM,2,Thursday,11,0,0,16,27,normal
1847,11:15:00 AM,30,Monday,60,10,9,27,106,normal
1848,9:00:00 AM,10,Tuesday,124,24,22,0,170,heavy
1849,2:15:00 PM,15,Sunday,50,23,16,8,97,normal
1850,12:00:00 PM,10,Tuesday,38,10,5,25,78,normal
1851,4:45:00 AM,26,Thursday,54,14,10,16,94,normal
1852,6:30:00 AM,12,Thursday,120,17,23,1,161,normal
1853,7:00:00 AM,24,Tuesday,101,20,47,5,173,heavy
1854,10:15:00 AM,16,Monday,15,10,23,20,68,normal
1855,6:30:00 PM,1,Wednesday,117,19,31,7,174,heavy
1856,11:15:00 AM,7,Tuesday,28,9,9,24,70,normal
1857,1:15:00 PM,14,Saturday,50,18,26,14,108,normal
1858,10:30:00 PM,3,Friday,10,4,0,30,44,normal
1859,11:15:00 AM,15,Sunday,33,9,11,21,74,normal
1860,5:45:00 AM,21,Sunday,79,1,10,6,96,low
1861,6:30:00 PM,21,Sunday,116,22,23,7,168,heavy
1862,1:45:00 AM,1,Wednesday,18,5,1,12,36,low
1863,12:30:00 AM,4,Saturday,10,4,1,16,31,normal
1864,7:15:00 PM,21,Sunday,59,25,13,27,124,high
1865,12:30:00 PM,29,Sunday,66,10,3,29,108,normal
1866,2:45:00 PM,13,Friday,153,50,23,3,229,heavy
1867,10:00:00 PM,19,Thursday,18,1,0,10,29,low
1868,7:15:00 PM,1,Wednesday,97,18,10,24,149,high
1869,3:00:00 AM,12,Thursday,18,5,0,28,51,normal
1870,8:15:00 PM,4,Saturday,87,16,15,14,132,normal
1871,9:00:00 AM,23,Monday,147,12,32,0,191,heavy
1872,7:45:00 AM,30,Monday,150,22,38,3,213,heavy
1873,12:00:00 AM,10,Tuesday,31,0,4,4,39,low
1874,6:45:00 AM,31,Tuesday,131,28,24,0,183,heavy
1875,5:30:00 PM,21,Sunday,101,23,45,5,174,heavy
1876,9:15:00 AM,8,Wednesday,72,5,15,20,112,normal
1877,12:30:00 AM,17,Tuesday,15,2,1,15,33,normal
1878,8:00:00 AM,1,Wednesday,128,15,43,5,191,heavy
1879,9:00:00 AM,3,Friday,36,20,0,13,69,normal
1880,3:30:00 PM,15,Sunday,21,30,5,5,61,low
1881,5:15:00 PM,24,Tuesday,119,22,32,9,182,heavy
1882,5:45:00 PM,23,Monday,111,33,28,5,177,heavy
1883,3:30:00 AM,12,Thursday,18,5,0,25,48,normal
1884,12:45:00 AM,3,Friday,11,2,0,17,30,normal
1885,8:15:00 AM,24,Tuesday,131,26,36,0,193,heavy
1886,1:00:00 PM,11,Wednesday,51,7,7,27,92,normal
1887,8:00:00 PM,7,Tuesday,76,24,14,15,129,normal
1888,3:00:00 AM,10,Tuesday,50,0,3,0,53,low
1889,10:00:00 PM,27,Friday,20,4,0,39,63,normal
1890,12:15:00 AM,28,Saturday,19,4,0,14,37,normal
1891,4:45:00 PM,27,Friday,82,20,15,2,119,normal
1892,9:00:00 AM,8,Wednesday,101,19,23,5,148,normal
1893,1:00:00 PM,12,Thursday,52,9,8,20,89,normal
1894,9:45:00 PM,31,Tuesday,61,9,18,24,112,high
1895,6:45:00 AM,17,Tuesday,137,38,39,2,216,heavy
1896,6:00:00 AM,2,Thursday,143,33,27,1,204,heavy
1897,1:15:00 AM,22,Saturday,17,5,0,24,46,normal
1898,11:00:00 AM,30,Monday,26,8,11,20,65,normal
1899,12:00:00 AM,5,Sunday,15,4,0,37,56,normal
1900,11:15:00 AM,9,Thursday,24,8,13,23,68,normal
1901,11:45:00 AM,4,Saturday,39,8,13,20,80,normal
1902,11:00:00 PM,24,Tuesday,20,1,1,27,49,normal
1903,3:30:00 AM,18,Wednesday,17,3,1,38,59,normal
1904,11:30:00 AM,26,Thursday,38,7,13,21,79,normal
1905,3:15:00 PM,3,Friday,76,21,6,1,104,low
1906,3:15:00 AM,6,Monday,20,0,1,36,57,normal
1907,12:45:00 AM,27,Friday,15,2,1,16,34,normal
1908,12:45:00 AM,2,Thursday,11,5,0,22,38,normal
1909,4:00:00 PM,8,Wednesday,145,12,24,8,189,heavy
1910,1:15:00 PM,19,Thursday,18,16,32,18,84,normal
1911,11:30:00 AM,5,Sunday,49,8,8,26,91,normal
1912,8:30:00 AM,2,Thursday,128,26,42,4,200,heavy
1913,4:30:00 AM,22,Saturday,59,29,9,14,111,normal
1914,5:45:00 AM,6,Monday,80,16,5,10,111,low
1915,6:00:00 AM,6,Monday,138,35,47,4,224,heavy
1916,4:00:00 PM,15,Sunday,129,28,40,6,203,heavy
1917,10:00:00 PM,13,Friday,15,5,0,18,38,normal
1918,9:15:00 PM,26,Thursday,102,5,12,17,136,normal
1919,6:45:00 PM,1,Wednesday,87,10,13,16,126,normal
1920,9:00:00 AM,14,Saturday,139,15,21,3,178,heavy
1921,12:00:00 PM,11,Wednesday,51,10,14,20,95,normal
1922,2:45:00 AM,1,Wednesday,11,0,0,35,46,normal
1923,11:30:00 PM,28,Saturday,18,5,0,40,63,normal
1924,10:30:00 AM,26,Thursday,13,19,39,12,83,normal
1925,7:30:00 PM,1,Wednesday,71,21,14,12,118,normal
1926,9:45:00 AM,10,Tuesday,32,22,38,21,113,high
1927,8:15:00 PM,28,Saturday,71,24,15,26,136,high
1928,9:45:00 AM,15,Sunday,37,5,13,11,66,low
1929,2:30:00 PM,26,Thursday,78,29,22,13,142,normal
1930,5:15:00 PM,4,Saturday,113,26,26,8,173,heavy
1931,4:00:00 PM,27,Friday,80,22,17,0,119,normal
1932,3:00:00 PM,10,Tuesday,43,26,11,20,100,normal
1933,2:45:00 PM,19,Thursday,8,26,34,9,77,normal
1934,4:00:00 PM,29,Sunday,120,14,25,8,167,normal
1935,12:45:00 PM,24,Tuesday,35,10,12,24,81,normal
1936,10:30:00 AM,10,Tuesday,76,7,11,15,109,normal
1937,9:00:00 PM,30,Monday,67,19,12,9,107,low
1938,3:15:00 PM,5,Sunday,94,20,7,10,131,normal
1939,11:30:00 AM,24,Tuesday,43,5,6,26,80,normal
1940,11:15:00 PM,3,Friday,20,2,0,19,41,normal
1941,11:45:00 AM,3,Friday,163,62,12,0,237,heavy
1942,3:15:00 PM,24,Tuesday,116,20,17,19,172,heavy
1943,9:45:00 PM,17,Tuesday,60,9,11,27,107,normal
1944,6:15:00 AM,27,Friday,58,14,0,15,87,normal
1945,3:00:00 PM,19,Thursday,31,10,27,8,76,normal
1946,2:15:00 PM,17,Tuesday,14,24,26,9,73,normal
1947,3:45:00 AM,20,Friday,15,4,1,16,36,normal
1948,10:30:00 PM,15,Sunday,17,4,0,23,44,normal
1949,3:45:00 AM,31,Tuesday,16,4,0,15,35,normal
1950,8:15:00 PM,15,Sunday,93,22,18,10,143,normal
1951,2:15:00 AM,28,Saturday,17,4,1,38,60,normal
1952,1:00:00 PM,4,Saturday,20,8,15,26,69,normal
1953,10:00:00 AM,24,Tuesday,90,25,26,10,151,high
1954,3:30:00 AM,25,Wednesday,19,0,1,39,59,normal
1955,11:00:00 PM,8,Wednesday,14,4,1,27,46,normal
1956,2:30:00 AM,25,Wednesday,20,5,0,24,49,normal
1957,4:30:00 AM,23,Monday,51,14,0,5,70,low
1958,4:30:00 PM,22,Saturday,106,35,41,5,187,heavy
1959,2:00:00 PM,7,Tuesday,113,20,7,13,153,normal
1960,7:00:00 AM,6,Monday,148,10,28,2,188,heavy
1961,8:00:00 PM,10,Tuesday,80,17,12,34,143,high
1962,3:45:00 PM,20,Friday,89,27,10,2,128,normal
1963,2:30:00 PM,30,Monday,101,22,39,19,181,heavy
1964,10:15:00 AM,31,Tuesday,66,25,13,13,117,normal
1965,7:00:00 PM,13,Friday,76,24,23,0,123,normal
1966,12:30:00 AM,2,Thursday,12,4,0,40,56,normal
1967,9:45:00 PM,8,Wednesday,107,15,12,24,158,high
1968,6:00:00 PM,10,Tuesday,138,34,28,5,205,heavy
1969,12:00:00 AM,20,Friday,17,5,0,37,59,normal
1970,12:15:00 AM,18,Wednesday,12,1,0,40,53,normal
1971,2:15:00 PM,11,Wednesday,60,21,26,11,118,high
1972,12:30:00 AM,8,Wednesday,16,3,1,11,31,low
1973,2:00:00 AM,27,Friday,19,1,0,38,58,normal
1974,4:15:00 AM,17,Tuesday,62,20,4,18,104,normal
1975,12:45:00 PM,21,Sunday,27,7,14,28,76,normal
1976,7:30:00 AM,29,Sunday,106,27,25,1,159,normal
1977,7:30:00 PM,30,Monday,104,22,11,13,150,normal
1978,1:15:00 PM,21,Sunday,114,21,5,14,154,normal
1979,1:15:00 PM,25,Wednesday,58,13,10,12,93,low
1980,11:00:00 PM,3,Friday,12,1,0,40,53,normal
1981,7:30:00 AM,26,Thursday,103,28,32,1,164,high
1982,8:45:00 AM,9,Thursday,110,35,45,2,192,heavy
1983,8:45:00 AM,11,Wednesday,125,21,20,1,167,normal
1984,2:45:00 PM,29,Sunday,15,12,18,15,60,normal
1985,9:30:00 PM,15,Sunday,104,22,17,23,166,high
1986,5:45:00 PM,9,Thursday,146,13,38,9,206,heavy
1987,6:45:00 PM,25,Wednesday,65,18,20,21,124,high
1988,6:15:00 PM,27,Friday,50,23,1,0,74,low
1989,9:15:00 PM,25,Wednesday,94,8,15,5,122,normal
1990,4:30:00 PM,4,Saturday,145,15,20,9,189,heavy
1991,6:30:00 AM,24,Tuesday,126,22,21,1,170,heavy
1992,11:00:00 PM,25,Wednesday,17,4,0,11,32,low
1993,10:15:00 AM,1,Wednesday,22,8,31,8,69,normal
1994,9:30:00 AM,11,Wednesday,89,8,12,13,122,normal
1995,1:15:00 PM,23,Monday,119,15,20,13,167,normal
1996,8:30:00 PM,31,Tuesday,86,8,19,7,120,normal
1997,9:30:00 PM,21,Sunday,75,5,12,21,113,high
1998,6:00:00 PM,28,Saturday,123,37,46,8,214,heavy
1999,4:00:00 PM,17,Tuesday,144,40,29,10,223,normal
2000,9:45:00 PM,10,Tuesday,53,21,20,10,104,normal
2001,9:30:00 AM,12,Thursday,24,8,17,25,74,normal
2002,10:45:00 PM,26,Thursday,17,2,0,17,36,normal
2003,11:15:00 AM,17,Tuesday,32,5,15,26,78,normal
2004,6:30:00 PM,13,Friday,67,29,1,0,97,low
2005,8:00:00 PM,28,Saturday,74,10,12,32,128,high
2006,2:00:00 AM,17,Tuesday,13,5,0,17,35,normal
2007,5:00:00 PM,12,Thursday,103,20,27,9,159,high
2008,1:15:00 AM,29,Sunday,11,0,1,31,43,normal
2009,9:00:00 PM,11,Wednesday,95,25,17,29,166,high
2010,2:15:00 PM,7,Tuesday,75,24,27,7,133,high
2011,3:30:00 AM,4,Saturday,19,5,1,38,63,normal
2012,11:15:00 PM,31,Tuesday,18,0,1,40,59,normal
2013,11:15:00 PM,13,Friday,17,0,0,22,39,normal
2014,1:45:00 AM,3,Friday,13,4,1,24,42,normal
2015,10:45:00 AM,6,Monday,53,2,29,24,108,normal
2016,8:00:00 PM,2,Thursday,71,22,12,14,119,normal
2017,11:45:00 PM,31,Tuesday,18,1,0,26,45,normal
2018,7:00:00 AM,23,Monday,105,35,24,2,166,normal
2019,1:45:00 PM,21,Sunday,68,29,29,20,146,high
2020,9:15:00 PM,12,Thursday,53,25,20,13,111,normal
2021,2:00:00 AM,26,Thursday,18,2,0,37,57,normal
2022,11:30:00 AM,13,Friday,151,52,13,0,216,heavy
2023,7:15:00 PM,29,Sunday,55,25,13,26,119,high
2024,11:45:00 PM,8,Wednesday,10,5,0,14,29,normal
2025,5:00:00 AM,21,Sunday,87,7,7,4,105,low
2026,2:15:00 PM,4,Saturday,28,19,27,5,79,normal
2027,1:45:00 PM,20,Friday,168,59,24,1,252,heavy
2028,7:30:00 AM,11,Wednesday,125,38,50,1,214,heavy
2029,12:30:00 PM,9,Thursday,53,7,11,22,93,normal
2030,11:00:00 AM,9,Thursday,31,9,11,28,79,normal
2031,7:15:00 AM,30,Monday,150,17,35,5,207,heavy
2032,1:00:00 AM,10,Tuesday,57,6,15,16,94,normal
2033,1:00:00 AM,24,Tuesday,11,4,0,12,27,low
2034,5:30:00 PM,26,Thursday,103,33,48,10,194,heavy
2035,6:00:00 PM,16,Monday,106,11,41,7,165,high
2036,6:00:00 AM,3,Friday,75,6,7,13,101,normal
2037,6:15:00 PM,17,Tuesday,113,38,44,9,204,heavy
2038,11:45:00 AM,29,Sunday,26,5,8,25,64,normal
2039,8:30:00 AM,10,Tuesday,150,36,25,1,212,heavy
2040,9:00:00 AM,26,Thursday,142,19,31,1,193,heavy
2041,10:00:00 PM,7,Tuesday,16,5,0,21,42,normal
2042,9:45:00 PM,16,Monday,90,6,18,32,146,high
2043,12:00:00 PM,19,Thursday,67,7,8,22,104,normal
2044,6:30:00 PM,16,Monday,101,13,20,7,141,normal
2045,11:00:00 AM,12,Thursday,60,5,14,21,100,normal
2046,8:30:00 AM,23,Monday,148,31,20,4,203,heavy
2047,6:00:00 PM,27,Friday,66,23,10,0,99,low
2048,7:00:00 PM,9,Thursday,109,23,14,26,172,heavy
2049,9:00:00 PM,7,Tuesday,110,18,18,10,156,normal
2050,6:00:00 AM,1,Wednesday,109,38,34,5,186,heavy
2051,9:30:00 PM,30,Monday,109,25,16,20,170,heavy
2052,11:00:00 AM,26,Thursday,57,10,4,27,98,normal
2053,6:00:00 PM,14,Saturday,128,37,20,9,194,heavy
2054,5:15:00 PM,20,Friday,61,20,25,1,107,normal
2055,7:15:00 AM,19,Thursday,149,10,47,3,209,heavy
2056,7:30:00 AM,4,Saturday,105,32,43,0,180,heavy
2057,11:45:00 AM,19,Thursday,68,5,5,24,102,normal
2058,10:15:00 PM,6,Monday,13,1,0,11,25,low
2059,12:30:00 AM,27,Friday,15,5,0,26,46,normal
2060,2:15:00 PM,24,Tuesday,70,18,5,19,112,normal
2061,3:30:00 PM,29,Sunday,27,27,32,10,96,normal
2062,4:30:00 AM,4,Saturday,96,29,6,17,148,normal
2063,2:15:00 PM,13,Friday,172,65,18,2,257,heavy
2064,11:15:00 PM,6,Monday,11,5,0,19,35,normal
2065,8:00:00 AM,24,Tuesday,137,40,21,5,203,heavy
2066,4:00:00 AM,4,Saturday,10,2,0,30,42,normal
2067,10:45:00 PM,18,Wednesday,20,2,0,37,59,normal
2068,11:15:00 AM,8,Wednesday,32,5,11,27,75,normal
2069,5:15:00 PM,21,Sunday,100,12,39,7,158,high
2070,6:15:00 PM,12,Thursday,104,31,30,5,170,heavy
2071,7:15:00 PM,25,Wednesday,85,15,20,29,149,high
2072,6:45:00 PM,26,Thursday,80,22,14,18,134,normal
2073,8:00:00 AM,5,Sunday,101,37,32,0,170,heavy
2074,4:15:00 AM,12,Thursday,62,24,7,2,95,low
2075,12:15:00 AM,4,Saturday,16,4,1,15,36,normal
2076,11:30:00 PM,7,Tuesday,13,1,0,30,44,normal
2077,1:45:00 AM,24,Tuesday,11,4,0,31,46,normal
2078,11:45:00 PM,16,Monday,10,4,1,12,27,low
2079,1:30:00 AM,1,Wednesday,15,0,1,13,29,normal
2080,4:00:00 AM,29,Sunday,16,0,0,30,46,normal
2081,11:45:00 PM,13,Friday,15,1,1,24,41,normal
2082,5:00:00 AM,2,Thursday,78,2,4,9,93,low
2083,8:30:00 AM,19,Thursday,140,34,31,1,206,heavy
2084,2:15:00 PM,25,Wednesday,6,11,37,15,69,normal
2085,3:00:00 AM,16,Monday,15,4,1,29,49,normal
2086,11:00:00 PM,30,Monday,18,4,0,11,33,low
2087,6:15:00 AM,18,Wednesday,129,39,43,0,211,heavy
2088,2:15:00 PM,3,Friday,180,49,17,0,246,heavy
2089,5:00:00 AM,4,Saturday,113,6,9,10,138,normal
2090,12:15:00 AM,13,Friday,20,0,1,23,44,normal
2091,10:30:00 AM,5,Sunday,91,16,28,9,144,high
2092,8:45:00 PM,26,Thursday,98,11,14,27,150,high
2093,10:00:00 AM,7,Tuesday,51,14,33,14,112,high
2094,12:45:00 AM,7,Tuesday,16,3,0,15,34,normal
2095,9:00:00 AM,19,Thursday,132,11,24,3,170,heavy
2096,5:00:00 PM,10,Tuesday,145,25,49,7,226,heavy
2097,4:00:00 PM,21,Sunday,138,18,20,8,184,heavy
2098,1:15:00 PM,2,Thursday,78,23,16,13,130,normal
2099,6:30:00 AM,11,Wednesday,125,34,37,1,197,heavy
2100,5:45:00 PM,31,Tuesday,149,26,43,5,223,normal
2101,9:15:00 AM,16,Monday,74,14,23,21,132,high
2102,7:45:00 PM,30,Monday,54,23,10,25,112,high
2103,3:00:00 PM,18,Wednesday,14,16,9,14,53,normal
2104,9:00:00 AM,6,Monday,103,35,50,2,190,heavy
2105,3:15:00 PM,9,Thursday,99,16,38,7,160,high
2106,9:00:00 AM,21,Sunday,121,13,25,2,161,normal
2107,8:30:00 PM,10,Tuesday,96,5,11,13,125,normal
2108,2:30:00 PM,15,Sunday,94,20,35,17,166,high
2109,6:30:00 AM,8,Wednesday,101,12,48,1,162,high
2110,7:45:00 AM,13,Friday,61,8,7,12,88,low
2111,9:30:00 AM,3,Friday,135,61,28,2,226,heavy
2112,3:00:00 AM,3,Friday,17,5,0,15,37,normal
2113,5:30:00 PM,15,Sunday,129,22,25,9,185,heavy
2114,7:45:00 AM,7,Tuesday,123,22,22,3,170,heavy
2115,3:00:00 AM,24,Tuesday,19,4,1,17,41,normal
2116,7:15:00 AM,13,Friday,31,11,0,14,56,normal
2117,10:30:00 AM,22,Saturday,50,25,25,28,128,high
2118,5:30:00 AM,3,Friday,44,7,1,11,63,low
2119,7:15:00 AM,6,Monday,127,38,48,0,213,heavy
2120,12:45:00 PM,27,Friday,152,51,22,2,227,heavy
2121,4:30:00 AM,30,Monday,99,7,3,6,115,normal
2122,3:45:00 AM,21,Sunday,14,2,1,24,41,normal
2123,10:15:00 PM,26,Thursday,10,4,1,37,52,normal
2124,8:15:00 AM,5,Sunday,109,11,48,1,169,heavy
2125,6:45:00 AM,11,Wednesday,125,19,25,4,173,heavy
2126,1:15:00 PM,6,Monday,28,29,26,5,88,normal
2127,11:45:00 PM,23,Monday,11,3,1,37,52,normal
2128,3:00:00 AM,17,Tuesday,14,0,0,16,30,normal
2129,11:00:00 AM,28,Saturday,36,9,9,30,84,normal
2130,10:45:00 PM,11,Wednesday,18,1,0,17,36,normal
2131,12:15:00 PM,21,Sunday,23,5,4,27,59,normal
2132,8:45:00 PM,5,Sunday,102,6,14,35,157,high
2133,4:30:00 AM,2,Thursday,107,0,1,2,110,low
2134,2:45:00 AM,26,Thursday,20,5,0,30,55,normal
2135,2:30:00 PM,7,Tuesday,71,21,38,11,141,high
2136,9:00:00 AM,20,Friday,54,11,0,13,78,normal
2137,4:00:00 AM,15,Sunday,14,1,1,34,50,normal
2138,11:30:00 AM,15,Sunday,32,9,10,30,81,normal
2139,8:00:00 PM,16,Monday,70,16,19,33,138,high
2140,5:30:00 AM,16,Monday,91,2,3,5,101,low
2141,12:15:00 AM,17,Tuesday,11,0,0,24,35,normal
2142,12:00:00 AM,30,Monday,13,3,1,12,29,low
2143,5:00:00 PM,16,Monday,128,22,28,8,186,heavy
2144,2:45:00 PM,26,Thursday,69,14,32,18,133,high
2145,1:45:00 AM,15,Sunday,19,0,1,30,50,normal
2146,6:15:00 AM,10,Tuesday,144,16,49,0,209,heavy
2147,8:30:00 AM,26,Thursday,144,39,50,1,234,heavy
2148,11:00:00 PM,22,Saturday,14,5,0,37,56,normal
2149,1:15:00 AM,10,Tuesday,44,0,5,4,53,low
2150,11:30:00 PM,11,Wednesday,18,3,1,28,50,normal
2151,2:30:00 PM,8,Wednesday,111,18,29,16,174,heavy
2152,10:45:00 PM,30,Monday,19,3,1,33,56,normal
2153,7:30:00 PM,12,Thursday,102,6,15,6,129,normal
2154,2:00:00 AM,24,Tuesday,19,2,1,33,55,normal
2155,9:30:00 PM,6,Monday,66,22,17,16,121,normal
2156,8:15:00 AM,18,Wednesday,140,20,36,0,196,heavy
2157,10:15:00 PM,17,Tuesday,14,2,0,35,51,normal
2158,10:00:00 AM,25,Wednesday,24,17,17,9,67,normal
2159,6:30:00 AM,22,Saturday,146,23,23,4,196,heavy
2160,12:00:00 AM,24,Tuesday,17,2,0,18,37,normal
2161,4:45:00 AM,12,Thursday,114,23,10,19,166,normal
2162,12:15:00 PM,2,Thursday,44,5,5,21,75,normal
2163,7:15:00 AM,23,Monday,150,25,36,0,211,heavy
2164,6:00:00 PM,31,Tuesday,117,34,36,10,197,heavy
2165,3:00:00 AM,27,Friday,19,5,1,18,43,normal
2166,6:00:00 AM,14,Saturday,120,12,22,3,157,normal
2167,6:30:00 AM,4,Saturday,105,33,29,4,171,heavy
2168,9:00:00 AM,12,Thursday,144,30,37,1,212,heavy
2169,1:00:00 PM,30,Monday,67,9,11,21,108,normal
2170,5:15:00 PM,13,Friday,85,20,4,0,109,low
2171,12:15:00 PM,27,Friday,136,60,27,2,225,heavy
2172,2:30:00 AM,12,Thursday,18,0,0,23,41,normal
2173,2:45:00 AM,5,Sunday,18,4,0,11,33,low
2174,4:30:00 PM,24,Tuesday,110,15,50,5,180,heavy
2175,11:45:00 AM,9,Thursday,60,10,5,25,100,normal
2176,5:15:00 AM,26,Thursday,64,27,5,5,101,low
2177,12:45:00 AM,29,Sunday,14,4,1,32,51,normal
2178,10:30:00 AM,25,Wednesday,100,12,5,23,140,high
2179,7:00:00 PM,16,Monday,108,6,17,23,154,high
2180,6:45:00 PM,8,Wednesday,59,6,20,6,91,normal
2181,7:30:00 PM,14,Saturday,85,12,11,18,126,normal
2182,1:30:00 PM,1,Wednesday,108,24,34,7,173,heavy
2183,1:15:00 AM,11,Wednesday,15,0,1,23,39,normal
2184,3:00:00 PM,21,Sunday,106,17,7,12,142,normal
2185,9:45:00 PM,19,Thursday,105,14,10,7,136,normal
2186,3:00:00 PM,31,Tuesday,25,24,19,10,78,normal
2187,1:45:00 AM,30,Monday,19,1,0,34,54,normal
2188,1:00:00 AM,7,Tuesday,12,5,1,21,39,normal
2189,5:15:00 AM,14,Saturday,103,2,10,20,135,normal
2190,2:45:00 AM,6,Monday,12,4,0,16,32,normal
2191,4:15:00 AM,15,Sunday,61,26,1,16,104,normal
2192,1:30:00 PM,10,Tuesday,84,24,22,18,148,normal
2193,11:15:00 AM,2,Thursday,60,10,3,28,101,normal
2194,3:15:00 PM,8,Wednesday,32,28,35,6,101,normal
2195,5:15:00 PM,25,Wednesday,142,40,22,6,210,heavy
2196,2:30:00 PM,14,Saturday,28,17,31,10,86,normal
2197,3:00:00 PM,15,Sunday,109,18,13,6,146,normal
2198,10:15:00 AM,26,Thursday,90,4,10,20,124,normal
2199,11:30:00 PM,18,Wednesday,19,0,0,35,54,normal
2200,6:45:00 PM,5,Sunday,78,15,14,28,135,high
2201,1:15:00 PM,4,Saturday,47,29,28,9,113,high
2202,4:45:00 AM,21,Sunday,100,15,8,20,143,normal
2203,3:15:00 PM,31,Tuesday,90,25,18,20,153,normal
2204,10:30:00 AM,8,Wednesday,56,18,9,23,106,normal
2205,8:45:00 PM,30,Monday,58,24,14,24,120,high
2206,1:45:00 PM,24,Tuesday,53,19,33,9,114,high
2207,6:15:00 AM,29,Sunday,147,31,46,0,224,heavy
2208,6:30:00 PM,25,Wednesday,148,27,39,6,220,heavy
2209,3:00:00 PM,30,Monday,20,19,25,8,72,normal
2210,9:30:00 PM,4,Saturday,56,20,11,25,112,high
2211,3:00:00 PM,5,Sunday,114,21,10,9,154,normal
2212,8:00:00 PM,22,Saturday,85,13,16,24,138,high
2213,5:00:00 PM,15,Sunday,125,35,37,5,202,heavy
2214,4:00:00 PM,22,Saturday,132,12,27,9,180,heavy
2215,10:00:00 PM,9,Thursday,17,4,1,20,42,normal
2216,4:30:00 AM,24,Tuesday,95,15,4,19,133,normal
2217,3:45:00 AM,29,Sunday,18,0,0,20,38,normal
2218,5:15:00 PM,16,Monday,103,17,23,8,151,normal
2219,4:15:00 PM,16,Monday,145,12,41,6,204,heavy
2220,7:45:00 PM,4,Saturday,71,14,17,30,132,high
2221,7:30:00 PM,26,Thursday,87,9,16,26,138,high
2222,5:45:00 PM,30,Monday,107,35,23,8,173,heavy
2223,10:30:00 PM,14,Saturday,17,1,1,17,36,normal
2224,2:15:00 AM,27,Friday,16,1,1,32,50,normal
2225,7:15:00 PM,23,Monday,53,15,13,23,104,normal
2226,9:15:00 PM,1,Wednesday,71,16,14,9,110,low
2227,10:30:00 AM,9,Thursday,26,16,13,16,71,normal
2228,6:30:00 PM,9,Thursday,135,31,34,8,208,heavy
2229,7:15:00 AM,18,Wednesday,120,22,29,1,172,heavy
2230,6:00:00 PM,11,Wednesday,116,23,20,8,167,normal
2231,7:45:00 AM,25,Wednesday,103,21,20,0,144,normal
2232,5:00:00 PM,26,Thursday,132,12,45,9,198,heavy
2233,11:00:00 AM,8,Wednesday,36,9,8,28,81,normal
2234,2:30:00 AM,3,Friday,15,1,0,26,42,normal
2235,9:45:00 PM,26,Thursday,101,15,12,35,163,high
2236,2:00:00 AM,18,Wednesday,15,0,1,37,53,normal
2237,4:45:00 PM,13,Friday,62,28,21,2,113,normal
2238,2:45:00 PM,14,Saturday,79,14,23,6,122,normal
2239,10:15:00 PM,13,Friday,11,2,0,15,28,normal
2240,11:45:00 PM,14,Saturday,18,1,1,35,55,normal
2241,9:15:00 AM,13,Friday,132,47,25,0,204,heavy
2242,1:00:00 PM,25,Wednesday,40,10,11,28,89,normal
2243,4:30:00 AM,20,Friday,27,15,6,10,58,low
2244,2:45:00 PM,17,Tuesday,47,14,29,6,96,normal
2245,7:30:00 AM,16,Monday,102,13,31,2,148,high
2246,8:45:00 PM,2,Thursday,100,17,16,33,166,high
2247,2:15:00 PM,21,Sunday,86,13,11,20,130,normal
2248,1:30:00 PM,19,Thursday,24,20,7,9,60,low
2249,8:00:00 AM,31,Tuesday,147,21,41,5,214,heavy
2250,9:00:00 AM,18,Wednesday,120,27,38,4,189,heavy
2251,7:30:00 PM,10,Tuesday,61,18,15,27,121,high
2252,6:15:00 AM,6,Monday,123,27,22,4,176,heavy
2253,2:30:00 AM,6,Monday,18,5,0,22,45,normal
2254,6:30:00 AM,10,Tuesday,111,28,20,3,162,normal
2255,1:30:00 PM,4,Saturday,51,27,10,20,108,normal
2256,7:45:00 PM,3,Friday,35,10,0,2,47,low
2257,9:30:00 AM,14,Saturday,13,11,39,7,70,normal
2258,12:30:00 PM,28,Saturday,65,10,8,22,105,normal
2259,7:15:00 AM,15,Sunday,150,13,31,4,198,heavy
2260,8:15:00 PM,2,Thursday,80,17,11,15,123,normal
2261,5:00:00 AM,11,Wednesday,81,25,1,18,125,normal
2262,3:00:00 AM,8,Wednesday,17,5,1,17,40,normal
2263,1:30:00 PM,28,Saturday,84,11,11,9,115,normal
2264,5:45:00 PM,29,Sunday,117,10,47,9,183,heavy
2265,1:15:00 PM,18,Wednesday,29,18,29,20,96,normal
2266,6:15:00 AM,11,Wednesday,125,39,49,3,216,heavy
2267,2:15:00 AM,16,Monday,10,1,1,21,33,normal
2268,3:15:00 PM,16,Monday,74,18,37,11,140,high
2269,2:00:00 AM,21,Sunday,18,5,0,29,52,normal
2270,7:30:00 PM,16,Monday,102,22,17,23,164,high
2271,2:30:00 AM,16,Monday,20,5,1,40,66,normal
2272,8:15:00 PM,11,Wednesday,55,17,12,19,103,normal
2273,1:30:00 PM,16,Monday,20,17,9,5,51,low
2274,4:00:00 AM,28,Saturday,18,3,0,17,38,normal
2275,4:00:00 AM,24,Tuesday,10,1,0,12,23,low
2276,3:45:00 AM,8,Wednesday,10,5,0,39,54,normal
2277,3:45:00 PM,18,Wednesday,40,15,28,5,88,normal
2278,5:00:00 AM,8,Wednesday,99,25,6,6,136,normal
2279,6:00:00 PM,29,Sunday,112,13,37,6,168,heavy
2280,10:45:00 AM,1,Wednesday,49,22,16,5,92,normal
2281,9:30:00 PM,13,Friday,21,2,5,15,43,normal
2282,11:00:00 PM,11,Wednesday,18,5,0,21,44,normal
2283,3:30:00 PM,17,Tuesday,99,24,30,10,163,high
2284,2:45:00 PM,23,Monday,107,11,26,19,163,high
2285,2:15:00 PM,22,Saturday,96,16,39,17,168,heavy
2286,3:30:00 PM,18,Wednesday,96,19,14,18,147,normal
2287,12:45:00 PM,7,Tuesday,65,9,15,22,111,normal
2288,6:15:00 AM,26,Thursday,145,21,40,5,211,heavy
2289,12:45:00 PM,8,Wednesday,58,10,5,27,100,normal
2290,4:30:00 PM,8,Wednesday,145,20,47,8,220,heavy
2291,9:15:00 AM,19,Thursday,23,8,40,27,98,normal
2292,9:15:00 PM,29,Sunday,73,9,13,5,100,low
2293,8:30:00 PM,13,Friday,22,3,6,1,32,low
2294,10:45:00 AM,18,Wednesday,23,3,37,18,81,normal
2295,9:00:00 PM,8,Wednesday,99,19,15,28,161,high
2296,1:45:00 AM,19,Thursday,13,1,0,28,42,normal
2297,4:00:00 PM,16,Monday,111,32,43,5,191,heavy
2298,9:00:00 AM,13,Friday,53,19,1,10,83,low
2299,2:45:00 PM,6,Monday,84,12,15,15,126,normal
2300,3:15:00 PM,13,Friday,56,28,6,2,92,low
2301,6:15:00 PM,5,Sunday,149,13,22,9,193,heavy
2302,1:45:00 PM,29,Sunday,76,29,15,19,139,normal
2303,5:45:00 AM,25,Wednesday,58,25,2,5,90,low
2304,3:00:00 PM,9,Thursday,53,21,6,11,91,low
2305,9:45:00 PM,13,Friday,31,2,1,9,43,low
2306,9:00:00 AM,31,Tuesday,145,25,20,5,195,heavy
2307,2:45:00 PM,12,Thursday,118,25,31,13,187,heavy
2308,2:00:00 PM,13,Friday,171,49,15,0,235,heavy
2309,5:15:00 AM,20,Friday,33,6,0,11,50,low
2310,4:45:00 PM,7,Tuesday,134,23,28,10,195,heavy
2311,11:15:00 PM,20,Friday,11,2,0,35,48,normal
2312,12:00:00 AM,19,Thursday,13,5,0,12,30,low
2313,6:15:00 PM,3,Friday,59,27,5,2,93,low
2314,6:30:00 PM,20,Friday,83,20,23,2,128,normal
2315,3:15:00 PM,20,Friday,66,29,24,1,120,normal
2316,8:15:00 PM,5,Sunday,82,8,17,29,136,high
2317,3:00:00 AM,25,Wednesday,10,4,1,37,52,normal
2318,1:30:00 PM,29,Sunday,75,20,7,11,113,normal
2319,7:30:00 AM,25,Wednesday,106,32,42,2,182,heavy
2320,7:15:00 PM,28,Saturday,94,14,14,24,146,high
2321,2:00:00 PM,14,Saturday,105,14,8,19,146,normal
2322,10:30:00 AM,1,Wednesday,31,23,19,12,85,normal
2323,11:30:00 AM,11,Wednesday,51,9,7,30,97,normal
2324,6:30:00 PM,4,Saturday,121,37,34,6,198,heavy
2325,3:15:00 AM,24,Tuesday,10,2,1,12,25,low
2326,11:00:00 AM,14,Saturday,54,5,13,23,95,normal
2327,6:00:00 AM,11,Wednesday,125,13,26,2,166,high
2328,3:15:00 AM,25,Wednesday,15,4,0,38,57,normal
2329,6:45:00 PM,9,Thursday,106,22,16,20,164,normal
2330,5:30:00 PM,13,Friday,87,24,11,2,124,normal
2331,2:00:00 PM,10,Tuesday,88,26,31,19,164,high
2332,8:30:00 AM,29,Sunday,135,23,37,5,200,heavy
2333,9:15:00 PM,8,Wednesday,93,14,20,17,144,normal
2334,4:15:00 AM,9,Thursday,85,24,5,5,119,normal
2335,12:00:00 PM,23,Monday,45,8,13,29,95,normal
2336,8:45:00 PM,18,Wednesday,74,9,13,6,102,low
2337,6:00:00 PM,2,Thursday,149,17,41,9,216,heavy
2338,10:30:00 AM,2,Thursday,77,23,14,20,134,normal
2339,10:00:00 AM,9,Thursday,47,20,18,16,101,normal
2340,5:30:00 PM,9,Thursday,138,27,21,7,193,heavy
2341,4:00:00 AM,13,Friday,11,0,0,27,38,normal
2342,12:30:00 PM,13,Friday,159,44,23,2,228,heavy
2343,12:45:00 PM,25,Wednesday,22,5,6,26,59,normal
2344,3:30:00 AM,10,Tuesday,129,22,42,1,194,heavy
2345,12:15:00 AM,5,Sunday,11,5,0,14,30,normal
2346,11:45:00 PM,27,Friday,12,0,0,17,29,normal
2347,5:30:00 AM,29,Sunday,86,5,1,13,105,normal
2348,2:15:00 AM,29,Sunday,17,4,1,20,42,normal
2349,9:30:00 AM,27,Friday,180,69,29,1,279,heavy
2350,3:15:00 AM,22,Saturday,18,2,1,12,33,low
2351,12:15:00 PM,5,Sunday,40,8,12,21,81,normal
2352,6:15:00 PM,1,Wednesday,144,20,22,7,193,heavy
2353,8:30:00 AM,18,Wednesday,107,13,31,4,155,high
2354,8:45:00 AM,13,Friday,58,7,5,13,83,normal
2355,10:00:00 AM,15,Sunday,82,17,31,20,150,high
2356,12:00:00 AM,14,Saturday,18,4,0,33,55,normal
2357,4:45:00 AM,14,Saturday,98,0,9,19,126,normal
2358,8:00:00 AM,27,Friday,31,14,3,14,62,normal
2359,2:30:00 PM,2,Thursday,34,17,21,14,86,normal
2360,10:00:00 AM,26,Thursday,84,11,27,26,148,high
2361,12:15:00 AM,16,Monday,13,3,0,26,42,normal
2362,3:45:00 PM,5,Sunday,56,17,15,8,96,low
2363,2:30:00 PM,16,Monday,105,30,24,8,167,normal
2364,12:15:00 PM,20,Friday,175,59,11,3,248,heavy
2365,11:00:00 PM,15,Sunday,10,0,1,31,42,normal
2366,9:00:00 PM,28,Saturday,104,22,10,14,150,normal
2367,12:45:00 PM,2,Thursday,38,8,15,27,88,normal
2368,4:45:00 PM,28,Saturday,105,20,23,7,155,normal
2369,4:30:00 AM,29,Sunday,102,17,2,14,135,normal
2370,4:15:00 AM,31,Tuesday,98,5,1,17,121,normal
2371,6:00:00 AM,25,Wednesday,113,40,36,4,193,heavy
2372,1:30:00 AM,2,Thursday,10,4,1,11,26,low
2373,1:15:00 AM,2,Thursday,14,3,0,39,56,normal
2374,4:30:00 PM,27,Friday,75,24,8,0,107,low
2375,6:15:00 PM,31,Tuesday,124,30,44,10,208,heavy
2376,1:30:00 PM,12,Thursday,14,21,7,18,60,normal
2377,2:30:00 AM,8,Wednesday,19,0,1,13,33,normal
2378,12:15:00 AM,31,Tuesday,19,3,0,18,40,normal
2379,6:45:00 AM,30,Monday,125,11,24,0,160,normal
